一卵孵双凤	yi'luan'fu'shuang'feng
一口咸蛋糕	yi'kou'xian'dan'gao
一口酥	yi'kou'su
一品官燕	yi'pin'guan'yan
一品寿桃	yi'pin'shou'tao
一品烧饼	yi'pin'shao'bing
一品熊掌	yi'pin'xiong'zhang
一品肉	yi'pin'rou
一品蒸黄鱼	yi'pin'zheng'huang'yu
一品豆腐汤	yi'pin'dou'fu'tang
一品豆腐	yi'pin'dou'fu
一品配方	yi'pin'pei'fang
一品酥方	yi'pin'su'fang
一品酸辣鸡	yi'pin'suan'la'ji
一品鲍鱼	yi'pin'bao'yu
一品鲳鱼	yi'pin'chang'yu
一品鲳	yi'pin'chang
一品	yi'pin
一见钟情	yi'jian'zhong'qing
一锭雪茶酥	yi'ding'xue'cha'su
丁二酮	ding'er'tong
丁基橡胶	ding'ji'xiang'jiao
丁基羟基茴香醚	ding'ji'qiang'ji'hui'xiang'mi
丁苯橡胶	ding'ben'xiang'jiao
丁酮	ding'tong
丁酰乳酸丁酯	ding'xian'ru'suan'ding'zhi
丁酸丁酯	ding'suan'ding'zhi
丁酸乙酯	ding'suan'yi'zhi
丁酸异戊酯	ding'suan'yi'wu'zhi
丁酸苄酯	ding'suan'bian'zhi
丁酸	ding'suan
丁香姜糖	ding'xiang'jiang'tang
丁香排骨	ding'xiang'pai'gu
丁香榄	ding'xiang'lan
丁香粉	ding'xiang'fen
丁香酚	ding'xiang'fen
丁香鸭	ding'xiang'ya
丁香	ding'xiang
七境堂绿茶	qi'jing'tang'lv'cha
七子饼茶	qi'zi'bing'cha
七层糕	qi'ceng'gao
七彩什锦煲	qi'cai'shi'jin'bao
七星丸	qi'xing'wan
七鳃鳗肉	qi'sai'man'rou
万年长青	wan'nian'chang'qing
万能烤箱	wan'neng'kao'xiang
三丁大包	san'ding'da'bao
三丁烩虾仁	san'ding'hui'xia'ren
三七乌骨鸡	san'qi'wu'gu'ji
三七汽锅鸡	san'qi'qi'guo'ji
三七蒸鸡	san'qi'zheng'ji
三不粘	san'bu'zhan
三丝敲鱼	san'si'qiao'yu
三丝汤	san'si'tang
三丝清炒蟹	san'si'qing'chao'xie
三丝牛肉卷	san'si'niu'rou'juan
三丝面疙瘩	san'si'mian'ge'da
三丝驼峰	san'si'tuo'feng
三丝鱼翅	san'si'yu'chi
三丝鱿鱼	san'si'you'yu
三冬肉片	san'dong'rou'pian
三创	san'chuang
三北藕丝糖	san'bei'ou'si'tang
三原蓼花糖	san'yuan'liao'hua'tang
三原蓼花	san'yuan'liao'hua
三味豆腐	san'wei'dou'fu
三娃串串香火锅	san'wa'chuan'chuan'xiang'huo'guo
三宝酱虾	san'bao'jiang'xia
三年古越花雕酒	san'nian'gu'yue'hua'diao'jiu
三年陈花雕酒	san'nian'chen'hua'diao'jiu
三彩大虾	san'cai'da'xia
三彩菠菜	san'cai'bo'cai
三得利	san'de'li
三文一品汤包	san'wen'yi'pin'tang'bao
三文治火腿	san'wen'zhi'huo'tui
三文鱼寿司卷	san'wen'yu'shou'si'juan
三文鱼馅饺子	san'wen'yu'xian'jiao'zi
三文鱼	san'wen'yu
三明治	san'ming'zhi
三杯面轮	san'bei'mian'lun
三杯鸡	san'bei'ji
三果酥	san'guo'su
三氯蔗糖	san'lv'zhe'tang
三涧料酒	san'jian'liao'jiu
三清碧兰	san'qing'bi'lan
三皮丝	san'pi'si
三益永糕点	san'yi'yong'gao'dian
三美豆腐	san'mei'dou'fu
三聚甘油单硬脂酸酯	san'ju'gan'you'dan'ying'zhi'suan'zhi
三聚磷酸钠	san'ju'lin'suan'na
三色杂烩粥	san'se'za'hui'zhou
三色粘糕	san'se'zhan'gao
三色糕	san'se'gao
三色糯米饭	san'se'nuo'mi'fan
三色蛋糕	san'se'dan'gao
三色蛋	san'se'dan
三色鱼丸汤	san'se'yu'wan'tang
三色鸡丁	san'se'ji'ding
三色鸡鱼丸	san'se'ji'yu'wan
三色龙虾	san'se'long'xia
三花减肥茶	san'hua'jian'fei'cha
三菇浸鱼云	san'gu'jin'yu'yun
三菌炖鸡	san'jun'dun'ji
三虾豆腐	san'xia'dou'fu
三蛇胆饮料	san'she'dan'yin'liao
三角火烧	san'jiao'huo'shao
三角酥	san'jiao'su
三鲜丸子	san'xian'wan'zi
三鲜木樨汤	san'xian'mu'xi'tang
三鲜水饺	san'xian'shui'jiao
三鲜砂锅	san'xian'sha'guo
三鲜米线	san'xian'mi'xian
三鲜苦瓜汤	san'xian'ku'gua'tang
三鲜茄子	san'xian'qie'zi
三鲜莲花酥	san'xian'lian'hua'su
三鲜蘑菇	san'xian'mo'gu
三鲜酿面筋	san'xian'niang'mian'jin
三鲜锅巴	san'xian'guo'ba
三鲜锅粑	san'xian'guo'ba
三鲜鱼翅	san'xian'yu'chi
三鲜鸭舌	san'xian'ya'she
三鼎	san'ding
上杂拌	shang'za'ban
上汤奶白菜	shang'tang'nai'bai'cai
上汤虾丸	shang'tang'xia'wan
上海市	shang'hai'shi
上海绿豆糕	shang'hai'lv'dou'gao
上海蜜饯	shang'hai'mi'jian
上海饼干	shang'hai'bing'gan
上清饮凉茶	shang'qing'yin'liang'cha
上清饮素糖凉茶	shang'qing'yin'su'tang'liang'cha
上清饮	shang'qing'yin
上素仙鹤	shang'su'xian'he
不溶性聚乙烯聚吡咯烷酮	bu'rong'xing'ju'yi'xi'ju'bi'luo'wan'tong
不饱和脂肪酸单甘脂	bu'bao'he'zhi'fang'suan'dan'gan'zhi
丘北银鱼	qiu'bei'yin'yu
丘北黑鱼	qiu'bei'hei'yu
丙二醇脂肪酸酯	bing'er'chun'zhi'fang'suan'zhi
丙二醇	bing'er'chun
丙氨酸	bing'an'suan
丙酸乙酯	bing'suan'yi'zhi
丙酸苄酯	bing'suan'bian'zhi
丙酸钙	bing'suan'gai
丙酸钠	bing'suan'na
东北酒	dong'bei'jiu
东古一品鲜	dong'gu'yi'pin'xian
东坡方肉	dong'po'fang'rou
东坡春鸠脍	dong'po'chun'jiu'kuai
东坡肉	dong'po'rou
东坡肘子	dong'po'zhou'zi
东坡蒸猪头	dong'po'zheng'zhu'tou
东坡鳊鱼	dong'po'bian'yu
东坡	dong'po
东壁龙珠	dong'bi'long'zhu
东安子鸡	dong'an'zi'ji
东安鸡	dong'an'ji
东山坞豆腐皮	dong'shan'wu'dou'fu'pi
东方海川	dong'fang'hai'chuan
东方蒙特尔	dong'fang'meng'te'er
东江盐焗鸡	dong'jiang'yan'ju'ji
东江菜	dong'jiang'cai
东江豆腐煲	dong'jiang'dou'fu'bao
东璧龙珠	dong'bi'long'zhu
东阴宫	dong'yin'gong
丝丝糕	si'si'gao
丝瓜炖豆腐	si'gua'dun'dou'fu
丝瓜猪肝瘦肉汤	si'gua'zhu'gan'shou'rou'tang
丝瓜百合猪肝汤	si'gua'bai'he'zhu'gan'tang
丝袜奶茶	si'wa'nai'cha
丝路春	si'lu'chun
两吃多宝鱼	liang'chi'duo'bao'yu
两吃菠菜	liang'chi'bo'cai
两情相悦	liang'qing'xiang'yue
两面火	liang'mian'huo
两香问政山笋	liang'xiang'wen'zheng'shan'sun
严州干菜鸭	yan'zhou'gan'cai'ya
严州雪梨	yan'zhou'xue'li
中华药膳	zhong'hua'yao'shan
中华蜜酒	zhong'hua'mi'jiu
中华酱龙骨	zhong'hua'jiang'long'gu
中国劲豹啤酒	zhong'guo'jin'bao'pi'jiu
中国劲酒	zhong'guo'jing'jiu
中国名菜软罐头	zhong'guo'ming'cai'ruan'guan'tou
中型芝士蛋糕	zhong'xing'zhi'shi'dan'gao
中山王酒	zhong'shan'wang'jiu
中德	zhong'de
中江挂面	zhong'jiang'gua'mian
中种吐司	zhong'zhong'tu'si
中菜罐头	zhong'cai'guan'tou
丰城冻米糖	feng'cheng'dong'mi'tang
丰年果糖	feng'nian'guo'tang
丰收龙舟	feng'shou'long'zhou
串串香	chuan'chuan'xiang
串烧海鲜	chuan'shao'hai'xian
串煎馄饨	chuan'jian'hun'tun
临安山核桃	lin'an'shan'he'tao
临平柑蔗	lin'ping'gan'zhe
临汝药酒	lin'ru'yao'jiu
临洮酥糖	lin'tao'su'tang
丹参黄豆汤	dan'shen'huang'dou'tang
丹玉极品饺子醋	dan'yu'ji'pin'jiao'zi'cu
丹玉蟹醋	dan'yu'xie'cu
丹玉镇江陈醋	dan'yu'zhen'jiang'chen'cu
丹玉镇江香醋	dan'yu'zhen'jiang'xiang'cu
丹麦酥	dan'mai'su
主席红烧肉	zhu'xi'hong'shao'rou
主教鸡尾酒	zhu'jiao'ji'wei'jiu
么么喳喳珍珠糖水	me'me'zha'zha'zhen'zhu'tang'shui
乌发仙人粥	wu'fa'xian'ren'zhou
乌发汤	wu'fa'tang
乌梅红糖饮	wu'mei'hong'tang'yin
乌毡帽	wu'zhan'mao
乌米倒提粽	wu'mi'dao'ti'zong
乌饭果	wu'fan'guo
乌骨鸡归黄汤	wu'gu'ji'gui'huang'tang
乌鱼蛋	wu'yu'dan
乌龙茶	wu'long'cha
乐啤露	le'pi'lu
乐昌白毛茶	le'chang'bai'mao'cha
乐满家	le'man'jia
乐而美汉堡	le'er'mei'han'bao
乙二胺四乙酸二钠	yi'er'an'si'yi'suan'er'na
乙基愈创木酚	yi'ji'yu'chuang'mu'fen
乙基香兰素	yi'ji'xiang'lan'su
乙基麦芽酚	yi'ji'mai'ya'fen
乙氧基喹	yi'yang'ji'kui
乙萘酚	yi'nai'fen
乙酰化二淀粉磷酸酯	yi'xian'hua'er'dian'fen'lin'suan'zhi
乙酰化单甘油脂肪酸酯	yi'xian'hua'dan'gan'you'zhi'fang'suan'zhi
乙酰磺胺酸钠	yi'xian'huang'an'suan'na
乙酰磺胺酸钾	yi'xian'huang'an'suan'jia
乙酸丁酯	yi'suan'ding'zhi
乙酸乙酯	yi'suan'yi'zhi
乙酸二甲基苄基原酯	yi'suan'er'jia'ji'bian'ji'yuan'zhi
乙酸异丁酸蔗糖酯	yi'suan'yi'ding'suan'zhe'tang'zhi
乙酸异戊酯	yi'suan'yi'wu'zhi
乙酸松油酯	yi'suan'song'you'zhi
乙酸生育酚	yi'suan'sheng'yu'fen
乙酸芳樟酯	yi'suan'fang'zhang'zhi
乙酸苄酯	yi'suan'bian'zhi
乙酸薄荷酯	yi'suan'bo'he'zhi
乙酸钙	yi'suan'gai
乙酸钠	yi'suan'na
乙酸香叶酯	yi'suan'xiang'ye'zhi
乙酸龙脑酯	yi'suan'long'nao'zhi
乙酸	yi'suan
乙醇	yi'chun
九华毛峰	jiu'hua'mao'feng
九姓团圆	jiu'xing'tuan'yuan
九层塔煎蛋	jiu'ceng'ta'jian'dan
九月肉片	jiu'yue'rou'pian
九泉山水	jiu'quan'shan'shui
九洞矿泉水	jiu'dong'kuang'quan'shui
九点半	jiu'dian'ban
九里飘香	jiu'li'piao'xiang
九阳汤锅	jiu'yang'tang'guo
九黄饼	jiu'huang'bing
九龙茶	jiu'long'cha
乡村小炒鸡	xiang'cun'xiao'chao'ji
乡村玉米饼	xiang'cun'yu'mi'bing
书籍蛋糕	shu'ji'dan'gao
乳化剂	ru'hua'ji
乳化硅油	ru'hua'gui'you
乳扇	ru'shan
乳椒空心菜	ru'jiao'kong'xin'cai
乳猪	ru'zhu
乳糖醇	ru'tang'chun
乳茶	ru'cha
乳酒	ru'jiu
乳酪蒸虾仁	ru'lao'zheng'xia'ren
乳酪蛋糕	ru'lao'dan'gao
乳酸乙酯	ru'suan'yi'zhi
乳酸亚铁	ru'suan'ya'tie
乳酸啤酒	ru'suan'pi'jiu
乳酸菌饮料	ru'suan'jun'yin'liao
乳酸钙	ru'suan'gai
乳酸钠	ru'suan'na
乳酸链球菌素	ru'suan'lian'qiu'jun'su
乳酸	ru'suan
乳铁蛋白	ru'tie'dan'bai
乳饼	ru'bing
乳鸽瓤猪肚	ru'ge'rang'zhu'du
乾县锅盔	qian'xian'guo'kui
乾坤蒸狗	qian'kun'zheng'gou
乾州锅盔	qian'zhou'guo'kui
事事平安	shi'shi'ping'an
二丁基羟基甲苯	er'ding'ji'qiang'ji'jia'ben
二仙烧羊肉	er'xian'shao'yang'rou
二姐兔丁	er'jie'tu'ding
二氢香豆素	er'qing'xiang'dou'su
二氧化氯	er'yang'hua'lv
二氧化硅	er'yang'hua'gui
二氧化硫	er'yang'hua'liu
二氧化碳	er'yang'hua'tan
二氧化钛	er'yang'hua'tai
二氯苯氧乙酸	er'lv'ben'yang'yi'suan
二甲基二碳酸盐	er'jia'ji'er'tan'suan'yan
二甲基聚硅氧烷	er'jia'ji'ju'gui'yang'wan
二甲基苄基原醇	er'jia'ji'bian'ji'yuan'chun
二苯醚	er'ben'mi
二藕汁	er'ou'zhi
二锅头	er'guo'tou
于尼库	yu'ni'ku
云南咖啡	yun'nan'ka'fei
云南回饼	yun'nan'hui'bing
云南省	yun'nan'sheng
云娜水果捞	yun'na'shui'guo'lao
云托八鲜	yun'tuo'ba'xian
云燕跳水	yun'yan'tiao'shui
云片糕	yun'pian'gao
云片鸽蛋	yun'pian'ge'dan
云片鹿角菜	yun'pian'lu'jiao'cai
云耳西芹炒肉片	yun'er'xi'qin'chao'rou'pian
云腿奶糖	yun'tui'nai'tang
云腿月饼	yun'tui'yue'bing
云腿炒苦瓜	yun'tui'chao'ku'gua
云腿罐头	yun'tui'guan'tou
云腿豆焖饭	yun'tui'dou'men'fan
云腿	yun'tui
云针	yun'zhen
云雾茶	yun'wu'cha
五丁鱼圆	wu'ding'yu'yuan
五丝洋粉	wu'si'yang'fen
五仁酥	wu'ren'su
五凤楼	wu'feng'lou
五加皮瘦肉粥	wu'jia'pi'shou'rou'zhou
五加皮酒	wu'jia'pi'jiu
五华尊	wu'hua'zun
五味明虾片	wu'wei'ming'xia'pian
五味煎蟹	wu'wei'jian'xie
五味白肉	wu'wei'bai'rou
五夫醉鸡	wu'fu'zui'ji
五字牌桔子硬糖	wu'zi'pai'ju'zi'ying'tang
五山池	wu'shan'chi
五彩小炒	wu'cai'xiao'chao
五彩炒蛇丝	wu'cai'chao'she'si
五彩牛肉丝	wu'cai'niu'rou'si
五彩虾松	wu'cai'xia'song
五彩蟹盒	wu'cai'xie'he
五指山茶	wu'zhi'shan'cha
五更肠旺	wu'geng'chang'wang
五月花糖水半桃水果罐头	wu'yue'hua'tang'shui'ban'tao'shui'guo'guan'tou
五果豆沙冻	wu'guo'dou'sha'dong
五柳青鱼	wu'liu'qing'yu
五柳鱼丝	wu'liu'yu'si
五柳鱼	wu'liu'yu
五柳鲜鱼	wu'liu'xian'yu
五柳黄花鱼	wu'liu'huang'hua'yu
五盖山米茶	wu'gai'shan'mi'cha
五碳双缩醛	wu'tan'shuang'suo'quan
五神饮	wu'shen'yin
五粮液	wu'liang'ye
五色大麻糕	wu'se'da'ma'gao
五色方糕	wu'se'fang'gao
五色鱼丁	wu'se'yu'ding
五花肉炒豆腐泡菜	wu'hua'rou'chao'dou'fu'pao'cai
五花茶	wu'hua'cha
五香狗肉	wu'xiang'gou'rou
五香粉	wu'xiang'fen
五香羊头肉	wu'xiang'yang'tou'rou
五香羊肉	wu'xiang'yang'rou
五香肥鸭	wu'xiang'fei'ya
五香脆皮鸡	wu'xiang'cui'pi'ji
五香花生	wu'xiang'hua'sheng
五香苦瓜	wu'xiang'ku'gua
五香豆腐干丝	wu'xiang'dou'fu'gan'si
五香酥饼	wu'xiang'su'bing
五香	wu'xiang
井岗翠绿	jing'gang'cui'lv
井研丝丝糕	jing'yan'si'si'gao
亚历山大	ya'li'shan'da
亚林炳章	ya'lin'bing'zhang
亚油酸	ya'you'suan
亚硒酸钠	ya'xi'suan'na
亚硝酸钠	ya'xiao'suan'na
亚硝酸钾	ya'xiao'suan'jia
亚硫酸氢钠	ya'liu'suan'qing'na
亚硫酸钠	ya'liu'suan'na
亚铁氰化钠	ya'tie'qing'hua'na
亚铁氰化钾	ya'tie'qing'hua'jia
亚麻籽胶	ya'ma'zi'jiao
亚麻酸	ya'ma'suan
亨氏茄汁焗豆	heng'shi'qie'zhi'ju'dou
亨氏骨髓蔬菜泥	heng'shi'gu'sui'shu'cai'ni
京八件	jing'ba'jian
京式月饼	jing'shi'yue'bing
京式酸辣汤	jing'shi'suan'la'tang
亮蓝铝色淀	liang'lan'lv'se'dian
亮蓝	liang'lan
人参地黄炖蜜糖	ren'shen'di'huang'dun'mi'tang
人参山楂晶	ren'shen'shan'zha'jing
人参枣汁	ren'shen'zao'zhi
人参枸杞酒	ren'shen'gou'qi'jiu
人参核桃仁粥	ren'shen'he'tao'ren'zhou
人参莲子粥	ren'shen'lian'zi'zhou
人参软饮料	ren'shen'ruan'yin'liao
人参鲫鱼粥	ren'shen'ji'yu'zhou
人参鸡肉汤	ren'shen'ji'rou'tang
人心果	ren'xin'guo
人蔘鸡	ren'shen'ji
亿优客	yi'you'ke
什锦一品锅	shi'jin'yi'pin'guo
什锦丁儿	shi'jin'ding'er
什锦冬果	shi'jin'dong'guo
什锦冬瓜帽	shi'jin'dong'gua'mao
什锦南糖	shi'jin'nan'tang
什锦土豆泥馅冰皮月饼	shi'jin'tu'dou'ni'xian'bing'pi'yue'bing
什锦暖锅	shi'jin'nuan'guo
什锦海参	shi'jin'hai'shen
什锦点心	shi'jin'dian'xin
什锦烩饭	shi'jin'hui'fan
什锦米饭罐头	shi'jin'mi'fan'guan'tou
什锦糕	shi'jin'gao
什锦肉糕	shi'jin'rou'gao
什锦葛仙米	shi'jin'ge'xian'mi
什锦蛋卷	shi'jin'dan'juan
什锦蜂窝豆腐	shi'jin'feng'wo'dou'fu
什锦豆腐汤	shi'jin'dou'fu'tang
什锦豆腐煲	shi'jin'dou'fu'bao
什锦豆腐	shi'jin'dou'fu
什锦锅子	shi'jin'guo'zi
什锦锅巴	shi'jin'guo'ba
什锦麦片	shi'jin'mai'pian
什锦麦胚饼	shi'jin'mai'pei'bing
什锦	shi'jin
仁寿芝麻糕	ren'shou'zhi'ma'gao
今朝缘	jin'zhao'yuan
今朝	jin'zhao
今生缘	jin'sheng'yuan
仙人掌果	xian'ren'zhang'guo
仙人掌茶	xian'ren'zhang'cha
仙度氏咖啡	xian'du'shi'ka'fei
仙灵脾	xian'ling'pi
仙鹤望金桥	xian'he'wang'jin'qiao
仙鹤鲍鱼	xian'he'bao'yu
代黄杏	dai'huang'xing
仲丁胺	zhong'ding'an
仲景羊肉汤	zhong'jing'yang'rou'tang
仿膳饽饽	fang'shan'bo'bo
伊力特	yi'li'te
伊村山野	yi'cun'shan'ye
伊牛	yi'niu
伍仁酥	wu'ren'su
伍佑糖麻花	wu'you'tang'ma'hua
伏特加	fu'te'jia
优质杏仁酥	you'zhi'xing'ren'su
优酸乳	you'suan'ru
传世彝方	chuan'shi'yi'fang
伯丁罕	bo'ding'han
伯爵茶	bo'jue'cha
伯顿	bo'dun
低亚硫酸钠	di'ya'liu'suan'na
低筋面粉	di'jin'mian'fen
低糖蜜饯	di'tang'mi'jian
低聚果糖	di'ju'guo'tang
低脂芝士蛋糕	di'zhi'zhi'shi'dan'gao
低醇啤酒	di'chun'pi'jiu
体力架饼干	ti'li'jia'bing'gan
何首乌山鸡	he'shou'wu'shan'ji
何首乌粉	he'shou'wu'fen
何首乌紫菜炖豆腐	he'shou'wu'zi'cai'dun'dou'fu
余姚瀑布茶	yu'yao'pu'bu'cha
佛山盲公饼	fo'shan'mang'gong'bing
佛手三丝	fo'shou'san'si
佛手包	fo'shou'bao
佛手广肚	fo'shou'guang'du
佛手排骨	fo'shou'pai'gu
佛手海参	fo'shou'hai'shen
佛手珠子	fo'shou'zhu'zi
佛手蜜饯	fo'shou'mi'jian
佛手酥	fo'shou'su
佛手金卷	fo'shou'jin'juan
佛跳墙	fo'tiao'qiang
佳肴大盘鸡	jia'yao'da'pan'ji
侗乡腌鱼	dong'xiang'yan'yu
促销装特级金标生抽王	cu'xiao'zhuang'te'ji'jin'biao'sheng'chou'wang
俄式咖啡	e'shi'ka'fei
俄罗斯稞麦面包	e'luo'si'ke'mai'mian'bao
保云苏	bao'yun'su
保健美茶和桂圆茶	bao'jian'mei'cha'he'gui'yuan'cha
保健茶	bao'jian'cha
保健饮料健康乐	bao'jian'yin'liao'jian'kang'le
信泰天誉	xin'tai'tian'yu
信远斋酸梅汤	xin'yuan'zhai'suan'mei'tang
信阳毛尖茶	xin'yang'mao'jian'cha
修水双井茶	xiu'shui'shuang'jing'cha
倍半碳酸钠	bei'ban'tan'suan'na
倭井潭状元糕	wo'jing'tan'zhuang'yuan'gao
倭井潭硬糕	wo'jing'tan'ying'gao
倭井潭色子糕	wo'jing'tan'shai'zi'gao
偏酒石酸	pian'jiu'shi'suan
健力宝	jian'li'bao
健力	jian'li
健尔茗	jian'er'ming
健康乐	jian'kang'le
健美茶	jian'mei'cha
健脑核桃排骨汤	jian'nao'he'tao'pai'gu'tang
健脑补肾鸡汤	jian'nao'bu'shen'ji'tang
偶氮玉红	ou'dan'yu'hong
偶氮甲酰胺	ou'dan'jia'xian'an
儿童茶饼	er'tong'cha'bing
儿童钙质饼干	er'tong'gai'zhi'bing'gan
元宝牛蒡	yuan'bao'niu'bang
元宝酥	yuan'bao'su
元蹄炖鸡	yuan'ti'dun'ji
兄弟	xiong'di
光环咖啡	guang'huan'ka'fei
光饼	guang'bing
克瓦斯	ke'wa'si
克罗地可	ke'luo'di'ke
克里斯汀抹茶小方	ke'li'si'ting'mo'cha'xiao'fang
免烤起司蛋糕	mian'kao'qi'si'dan'gao
兔耳草醛	tu'er'cao'quan
兔肉炖鸡脚	tu'rou'dun'ji'jiao
兔肝鸡蛋汤	tu'gan'ji'dan'tang
兔脯	tu'pu
党参生鱼	dang'shen'sheng'yu
党参羊肉	dang'shen'yang'rou
党参麦冬瘦肉汤	dang'shen'mai'dong'shou'rou'tang
党参黄芪炖鸡汤	dang'shen'huang'qi'dun'ji'tang
兢山泉	jing'shan'quan
全丝烩鱼翅	quan'si'hui'yu'chi
全家富	quan'jia'fu
全家福	quan'jia'fu
全桃罐头	quan'tao'guan'tou
全羊汤锅	quan'yang'tang'guo
全虾三做	quan'xia'san'zuo
全麦芽啤酒	quan'mai'ya'pi'jiu
八仙瑶池聚会	ba'xian'yao'chi'ju'hui
八仙茶	ba'xian'cha
八仙过海闹罗汉	ba'xian'guo'hai'nao'luo'han
八代鱼	ba'dai'yu
八公山豆腐	ba'gong'shan'dou'fu
八味酿笋	ba'wei'niang'sun
八块鸡	ba'kuai'ji
八宝原壳鲜贝	ba'bao'yuan'ke'xian'bei
八宝壶	ba'bao'hu
八宝山药泥	ba'bao'shan'yao'ni
八宝桂鱼	ba'bao'gui'yu
八宝梨罐	ba'bao'li'guan
八宝榛子酱	ba'bao'zhen'zi'jiang
八宝油糕	ba'bao'you'gao
八宝炒年糕	ba'bao'chao'nian'gao
八宝瓤苹果	ba'bao'rang'ping'guo
八宝甲鱼	ba'bao'jia'yu
八宝糯米鸡	ba'bao'nuo'mi'ji
八宝膳粥	ba'bao'shan'zhou
八宝菠菜	ba'bao'bo'cai
八宝葫芦鸡	ba'bao'hu'lu'ji
八宝蒸乌鸡	ba'bao'zheng'wu'ji
八宝蜜食	ba'bao'mi'shi
八宝酿香瓜	ba'bao'niang'xiang'gua
八宝青蟹饭	ba'bao'qing'xie'fan
八宝饭	ba'bao'fan
八宝香糯	ba'bao'xiang'nuo
八宝鸡	ba'bao'ji
八宝鸭羹	ba'bao'ya'geng
八宝鸭	ba'bao'ya
八宝	ba'bao
八步红瓜子	ba'bu'hong'gua'zi
八王寺汽水	ba'wang'si'qi'shui
八珍糕	ba'zhen'gao
八生火锅	ba'sheng'huo'guo
八角茴香油	ba'jiao'hui'xiang'you
八馅寿桃	ba'xian'shou'tao
公爵樱桃	gong'jue'ying'tao
六偏磷酸钠	liu'pian'lin'suan'na
六堡茶	liu'bao'cha
六安瓜片茶	lu'an'gua'pian'cha
六安篮茶	lu'an'lan'cha
六必居酱菜	liu'bi'ju'jiang'cai
六曲香	liu'qu'xiang
六百居香肠粉肚	liu'bai'ju'xiang'chang'fen'du
六聚甘油单油酸酯	liu'ju'gan'you'dan'you'suan'zhi
六聚甘油单硬脂酸酯	liu'ju'gan'you'dan'ying'zhi'suan'zhi
兰度鸽脯	lan'du'ge'pu
兰花八宝冬瓜	lan'hua'ba'bao'dong'gua
兰花大虾	lan'hua'da'xia
兰花春笋	lan'hua'chun'sun
兰花茶	lan'hua'cha
兰花豆干	lan'hua'dou'gan
兴业容器	xing'ye'rong'qi
兴隆咖啡	xing'long'ka'fei
养生汤	yang'sheng'tang
养生肉桂奶茶	yang'sheng'rou'gui'nai'cha
养生菜根	yang'sheng'cai'gen
养胃酥	yang'wei'su
养血安胎汤	yang'xue'an'tai'tang
内江药疗蜜饯	nei'jiang'yao'liao'mi'jian
内江蜜饯	nei'jiang'mi'jian
内蒙古自治区	nei'meng'gu'zi'zhi'qu
农夫果园	nong'fu'guo'yuan
农夫茶	nong'fu'cha
农家茶	nong'jia'cha
冠生园	guan'sheng'yuan
冠生牌糖果	guan'sheng'pai'tang'guo
冬杏田鸡精	dong'xing'tian'ji'jing
冬枣	dong'zao
冬瓜排骨海带汤	dong'gua'pai'gu'hai'dai'tang
冬瓜排骨清汤	dong'gua'pai'gu'qing'tang
冬瓜汤谱	dong'gua'tang'pu
冬瓜炖排骨	dong'gua'dun'pai'gu
冬瓜煎饺	dong'gua'jian'jiao
冬瓜煲汤	dong'gua'bao'tang
冬瓜燕	dong'gua'yan
冬瓜竹笋鸡	dong'gua'zhu'sun'ji
冬瓜连锅汤	dong'gua'lian'guo'tang
冬瓜鲜荷叶煲鸭	dong'gua'xian'he'ye'bao'ya
冬瓜鳖裙羹	dong'gua'bie'qun'geng
冬瓜鳢鱼汤	dong'gua'li'yu'tang
冬瓜	dong'gua
冬笋三黄鸡	dong'sun'san'huang'ji
冬笋虾卷	dong'sun'xia'juan
冬笋里脊丝	dong'sun'li'ji'si
冬笋雪菜黄鱼汤	dong'sun'xue'cai'huang'yu'tang
冬笋鸽脯	dong'sun'ge'pu
冬菇扒茼蒿	dong'gu'ba'tong'hao
冬菇烧蹄筋	dong'gu'shao'ti'jin
冬菇藕夹	dong'gu'ou'jia
冬菇雪耳猪胰汤	dong'gu'xue'er'zhu'yi'tang
冬菇马蹄苋菜豆腐羹	dong'gu'ma'ti'xian'cai'dou'fu'geng
冬菇鸡脚汤	dong'gu'ji'jiao'tang
冬菜扣肉	dong'cai'kou'rou
冬菜炖鸭	dong'cai'dun'ya
冬菜肉末	dong'cai'rou'mo
冬蓉酥	dong'rong'su
冬虫夏草烩番茄	dong'chong'xia'cao'hui'fan'qie
冬虫夏草龟汤	dong'chong'xia'cao'gui'tang
冬虫草炖水鱼	dong'chong'cao'dun'shui'yu
冯了性药酒	feng'le'xing'yao'jiu
冰之恋	bing'zhi'lian
冰冻牛油蛋糕	bing'dong'niu'you'dan'gao
冰卡布奇诺	bing'ka'bu'qi'nuo
冰峰	bing'feng
冰拿铁咖啡	bing'na'tie'ka'fei
冰拿铁	bing'na'tie
冰沙	bing'sha
冰淇淋可可卷	bing'qi'lin'ke'ke'juan
冰淇淋蛋糕	bing'qi'lin'dan'gao
冰激凌蛋糕	bing'ji'ling'dan'gao
冰激凌	bing'ji'ling
冰片糖	bing'pian'tang
冰皮月饼	bing'pi'yue'bing
冰皮盐水鸡	bing'pi'yan'shui'ji
冰皮蛋糕	bing'pi'dan'gao
冰粉	bing'fen
冰糖乳鸽燕窝羹	bing'tang'ru'ge'yan'wo'geng
冰糖哈士蟆	bing'tang'ha'shi'ma
冰糖湘莲	bing'tang'xiang'lian
冰糖燕窝	bing'tang'yan'wo
冰糖百果饼	bing'tang'bai'guo'bing
冰糖莲子	bing'tang'lian'zi
冰糖葫芦	bing'tang'hu'lu
冰糖蒸鸡胆	bing'tang'zheng'ji'dan
冰糖银耳羹	bing'tang'yin'er'geng
冰糖麻雀	bing'tang'ma'que
冰糖	bing'tang
冰结构蛋白	bing'jie'gou'dan'bai
冰花士干圈	bing'hua'shi'gan'quan
冰花雪莲	bing'hua'xue'lian
冰蓼花	bing'liao'hua
冰醋酸	bing'cu'suan
冰镇番茄汁	bing'zhen'fan'qie'zhi
冰镇胡萝卜汁	bing'zhen'hu'luo'bo'zhi
冰镇芦笋汁	bing'zhen'lu'sun'zhi
冰鲜三扒一霖	bing'xian'san'ba'yi'lin
冰鲜三角肉	bing'xian'san'jiao'rou
冰鲜上脑	bing'xian'shang'nao
冰鲜什果西米捞	bing'xian'shen'guo'xi'mi'lao
冰鲜小黄瓜条	bing'xian'xiao'huang'gua'tiao
冰鲜尾龙扒	bing'xian'wei'long'ba
冰鲜带油外脊	bing'xian'dai'you'wai'ji
冰鲜板腱	bing'xian'ban'jian
冰鲜牛胸	bing'xian'niu'xiong
冰鲜牛腩	bing'xian'niu'nan
冰鲜牛腱	bing'xian'niu'jian
冰鲜眼肉	bing'xian'yan'rou
冰鲜肩肉	bing'xian'jian'rou
冰鲜胸腩腹肉	bing'xian'xiong'nan'fu'rou
冰鲜胸腹	bing'xian'xiong'fu
冰鲜脍扒	bing'xian'kuai'ba
冰鲜腹肉	bing'xian'fu'rou
冰鲜里脊	bing'xian'li'ji
冰鲜金钱展	bing'xian'jin'qian'zhan
冰鲜针扒	bing'xian'zhen'ba
冰鲜霖肉	bing'xian'lin'rou
冰鲜	bing'xian
决明子粥	jue'ming'zi'zhou
决明子茶	jue'ming'zi'cha
决明枸杞茶	jue'ming'gou'qi'cha
决明胶	jue'ming'jiao
决明荷叶茶	jue'ming'he'ye'cha
冷冻上脑扒片	leng'dong'shang'nao'ba'pian
冷冻外脊扒片	leng'dong'wai'ji'ba'pian
冷冻外脊	leng'dong'wai'ji
冷冻大黄瓜条	leng'dong'da'huang'gua'tiao
冷冻小牛柳	leng'dong'xiao'niu'liu
冷冻小肋排	leng'dong'xiao'lei'pai
冷冻小黄瓜条	leng'dong'xiao'huang'gua'tiao
冷冻尾龙扒	leng'dong'wei'long'ba
冷冻带油三角肉	leng'dong'dai'you'san'jiao'rou
冷冻带油外脊	leng'dong'dai'you'wai'ji
冷冻板腱	leng'dong'ban'jian
冷冻牛前腿	leng'dong'niu'qian'tui
冷冻牛前	leng'dong'niu'qian
冷冻牛后腿肉	leng'dong'niu'hou'tui'rou
冷冻牛尾	leng'dong'niu'wei
冷冻牛心	leng'dong'niu'xin
冷冻牛肚	leng'dong'niu'du
冷冻牛肝	leng'dong'niu'gan
冷冻牛胸腩	leng'dong'niu'xiong'nan
冷冻牛胸	leng'dong'niu'xiong
冷冻牛腱	leng'dong'niu'jian
冷冻牛舌	leng'dong'niu'she
冷冻牛蹄	leng'dong'niu'ti
冷冻牛鞭	leng'dong'niu'bian
冷冻眼肉扒片	leng'dong'yan'rou'ba'pian
冷冻眼肉	leng'dong'yan'rou
冷冻精修腹肉	leng'dong'jing'xiu'fu'rou
冷冻精碎肉	leng'dong'jing'sui'rou
冷冻肋条肉	leng'dong'lei'tiao'rou
冷冻肥牛一号板	leng'dong'fei'niu'yi'hao'ban
冷冻肥牛三号板	leng'dong'fei'niu'san'hao'ban
冷冻肥牛二号板	leng'dong'fei'niu'er'hao'ban
冷冻肥牛号	leng'dong'fei'niu'hao
冷冻肩肉	leng'dong'jian'rou
冷冻脍扒	leng'dong'kuai'ba
冷冻脖肉	leng'dong'bo'rou
冷冻辣椒肉	leng'dong'la'jiao'rou
冷冻金钱展	leng'dong'jin'qian'zhan
冷冻金钱肚	leng'dong'jin'qian'du
冷冻针扒	leng'dong'zhen'ba
冷冻霖肉	leng'dong'lin'rou
冷冻首霖	leng'dong'shou'lin
冷冻鸭掌	leng'dong'ya'zhang
冷冻	leng'dong
冷啖杯	leng'dan'bei
冻水茶	dong'shui'cha
冻豆腐金针	dong'dou'fu'jin'zhen
冻银鱼	dong'yin'yu
准立	zhun'li
凉拌三色	liang'ban'san'se
凉拌冬瓜	liang'ban'dong'gua
凉拌四宝	liang'ban'si'bao
凉拌海带	liang'ban'hai'dai
凉拌牛蒡	liang'ban'niu'bang
凉拌白萝卜丝	liang'ban'bai'luo'bo'si
凉拌红萝卜	liang'ban'hong'luo'bo
凉拌芫荽	liang'ban'yan'sui
凉拌茭白	liang'ban'jiao'bai
凉拌藕片	liang'ban'ou'pian
凉拌藕	liang'ban'ou
凉拌豆腐	liang'ban'dou'fu
凉拌豇豆	liang'ban'jiang'dou
凉拌辣味螺	liang'ban'la'wei'luo
凉拌馄饨皮	liang'ban'hun'tun'pi
凉拌鱿鱼	liang'ban'you'yu
凉拌鸡丝	liang'ban'ji'si
凉拌	liang'ban
凉瓜排骨	liang'gua'pai'gu
凉瓜浸田鸡	liang'gua'jin'tian'ji
凉瓜牛肉丝	liang'gua'niu'rou'si
凉瓜肉排汤	liang'gua'rou'pai'tang
凉皮	liang'pi
凉粉鲫鱼	liang'fen'ji'yu
凉粉	liang'fen
凉面饼子	liang'mian'bing'zi
凉面	liang'mian
凌云白毫	ling'yun'bai'hao
减肥菜谱香菇豆腐	jian'fei'cai'pu'xiang'gu'dou'fu
凝固剂	ning'gu'ji
几丁质	ji'ding'zhi
凤丝仙人掌	feng'si'xian'ren'zhang
凤凰出世	feng'huang'chu'shi
凤凰展翅	feng'huang'zhan'chi
凤凰水仙茶	feng'huang'shui'xian'cha
凤凰舌尖茶	feng'huang'she'jian'cha
凤凰萝卜	feng'huang'luo'bo
凤凰趴窝	feng'huang'pa'wo
凤凰鱼翅	feng'huang'yu'chi
凤凰鱼肚	feng'huang'yu'du
凤吞翅	feng'tun'chi
凤尾群翅	feng'wei'qun'chi
凤尾腰花	feng'wei'yao'hua
凤尾虾排	feng'wei'xia'pai
凤尾酥	feng'wei'su
凤尾金鱼	feng'wei'jin'yu
凤尾鱼罐头	feng'wei'yu'guan'tou
凤干酥	feng'gan'su
凤戏牡丹	feng'xi'mu'dan
凤梨咕噜虾球	feng'li'gu'lu'xia'qiu
凤梨咖喱鸡	feng'li'ga'li'ji
凤梨果泥	feng'li'guo'ni
凤梨汤圆	feng'li'tang'yuan
凤梨火腿蛋琣果	feng'li'huo'tui'dan'beng'guo
凤梨烩排骨	feng'li'hui'pai'gu
凤梨罐头	feng'li'guan'tou
凤梨蟹柳	feng'li'xie'liu
凤炖牡丹	feng'dun'mu'dan
凤眼秋波	feng'yan'qiu'bo
凤筋龙爪	feng'jin'long'zhua
凤翔腊驴肉	feng'xiang'la'lv'rou
凤翔豆花泡馍	feng'xiang'dou'hua'pao'mo
凤脯珍珠	feng'pu'zhen'zhu
凤阳酿豆腐	feng'yang'niang'dou'fu
凯司令蛋糕	kai'si'ling'dan'gao
凯复春	kai'fu'chun
凯撒沙律	kai'sa'sha'lv
出口马蹄	chu'kou'ma'ti
刀狼	dao'lang
切白卷蛋糕	qie'bai'juan'dan'gao
切糕	qie'gao
切边缸炉	qie'bian'gang'lu
刘家玉米香油茶	liu'jia'yu'mi'xiang'you'cha
创意酸奶水果沙拉	chuang'yi'suan'nai'shui'guo'sha'la
初次见面	chu'ci'jian'mian
利口葡萄酒	li'kou'pu'tao'jiu
利嘉	li'jia
制川乌	zhi'chuan'wu
刺云实胶	ci'yun'shi'jiao
刺梨夹心饼干	ci'li'jia'xin'bing'gan
刺猬包	ci'wei'bao
刺玫瑰	ci'mei'gui
刺菱角	ci'ling'jiao
剁椒小芋头	duo'jiao'xiao'yu'tou
剁椒胖鱼头	duo'jiao'pang'yu'tou
剁椒蒸鳊鱼	duo'jiao'zheng'bian'yu
剁椒鱼头	duo'jiao'yu'tou
剁椒	duo'jiao
前岗辉白茶	qian'gang'hui'bai'cha
剑南春	jian'nan'chun
剑花蜜枣猪肺汤	jian'hua'mi'zao'zhu'fei'tang
力存	li'cun
力神	li'shen
功德林素月饼	gong'de'lin'su'yue'bing
加味二妙散	jia'wei'er'miao'san
加头珠江鸳鸯月饼	jia'tou'zhu'jiang'yuan'yang'yue'bing
加州庄园	jia'zhou'zhuang'yuan
加馅卷糕	jia'xian'juan'gao
动物油	dong'wu'you
劲风	jing'feng
勃郎宁块	bo'lang'ning'kuai
包浆豆腐	bao'jiang'dou'fu
包菜派	bao'cai'pai
包袱酥	bao'fu'su
化核加应子	hua'he'jia'ying'zi
北京市	bei'jing'shi
北京米花糖	bei'jing'mi'hua'tang
北京美晶	bei'jing'mei'jing
北京蜜饯果脯	bei'jing'mi'jian'guo'fu
北方嘉宾	bei'fang'jia'bin
北杏参地老鸭汤	bei'xing'can'di'lao'ya'tang
北杏猪肺汤	bei'xing'zhu'fei'tang
北芪瘦肉	bei'qi'shou'rou
北芪茶酥	bei'qi'cha'su
十二烷基二甲基溴化铵	shi'er'wan'ji'er'jia'ji'xiu'hua'an
十二酸乙酯	shi'er'suan'yi'zhi
十全大补汤	shi'quan'da'bu'tang
十八烷酸	shi'ba'wan'suan
十里香茶	shi'li'xiang'cha
千层油糕	qian'ceng'you'gao
千层糕	qian'ceng'gao
千层肉饼	qian'ceng'rou'bing
千层蛋	qian'ceng'dan
千层酥	qian'ceng'su
千岛汁鸡球	qian'dao'zhi'ji'qiu
千岛湖红烧鱼头	qian'dao'hu'hong'shao'yu'tou
千彩纯	qian'cai'chun
千秋堰	qian'qiu'yan
半月	ban'yue
半煎煮银鱼	ban'jian'zhu'yin'yu
半胱氨酸盐酸盐	ban'guang'an'suan'yan'suan'yan
华凌	hua'ling
华夫饼干	hua'fu'bing'gan
华尔兹酪包	hua'er'zi'lao'bao
华泰名茶	hua'tai'ming'cha
华珍	hua'zhen
华顶云雾茶	hua'ding'yun'wu'cha
协盛隆萨其玛	xie'sheng'long'sa'qi'ma
单县四君子酒	shan'xian'si'jun'zi'jiu
单县羊肉汤	shan'xian'yang'rou'tang
单硬脂酸甘油酯	dan'ying'zhi'suan'gan'you'zhi
单辛酸甘油酯	dan'xin'suan'gan'you'zhi
南乳小凤饼	nan'ru'xiao'feng'bing
南乳笋鸡	nan'ru'sun'ji
南乳肉	nan'ru'rou
南京云中的蓝莓芝士	nan'jing'yun'zhong'de'lan'mei'zhi'shi
南京雨花茶	nan'jing'yu'hua'cha
南北杏仁鹌鹑汤	nan'bei'xing'ren'an'chun'tang
南北杏川贝炖鹧鸪	nan'bei'xing'chuan'bei'dun'zhe'gu
南北杏	nan'bei'xing
南国恋曲冰咖啡	nan'guo'lian'qu'bing'ka'fei
南宁鸡蛋糕	nan'ning'ji'dan'gao
南安红啤酒	nan'an'hong'pi'jiu
南宋定胜糕	nan'song'ding'sheng'gao
南山庄园	nan'shan'zhuang'yuan
南山白毛茶	nan'shan'bai'mao'cha
南岳云雾茶	nan'yue'yun'wu'cha
南康珍珠蜜枣	nan'kang'zhen'zhu'mi'zao
南排杂烩	nan'pai'za'hui
南昌炒粉	nan'chang'chao'fen
南昌麻仁香酥	nan'chang'ma'ren'xiang'su
南极磷虾罐头	nan'ji'lin'xia'guan'tou
南椒盐饼	nan'jiao'yan'bing
南湖蟹粉	nan'hu'xie'fen
南煎丸子	nan'jian'wan'zi
南煎肝	nan'jian'gan
南瓜冰糖水	nan'gua'bing'tang'shui
南瓜小点	nan'gua'xiao'dian
南瓜干儿糕	nan'gua'gan'er'gao
南瓜汤	nan'gua'tang
南瓜炒虾米	nan'gua'chao'xia'mi
南瓜百合爽	nan'gua'bai'he'shuang
南瓜红枣排骨汤	nan'gua'hong'zao'pai'gu'tang
南瓜花粥	nan'gua'hua'zhou
南瓜蒸肉	nan'gua'zheng'rou
南瓜蔓越莓吐司	nan'gua'man'yue'mei'tu'si
南瓜酸奶冻	nan'gua'suan'nai'dong
南瓜饼	nan'gua'bing
南瓶晚钟	nan'ping'wan'zhong
南糯白毫	nan'nuo'bai'hao
南美白对虾	nan'mei'bai'dui'xia
南肉春笋	nan'rou'chun'sun
南荠烧鸭丁	nan'ji'shao'ya'ding
南荠草莓饼	nan'ji'cao'mei'bing
博普	bo'pu
卡依之	ka'yi'zhi
卡夫奇妙酱	ka'fu'qi'miao'jiang
卡夫果珍	ka'fu'guo'zhen
卡布基诺	ka'bu'ji'nuo
卡布奇诺冰咖啡	ka'bu'qi'nuo'bing'ka'fei
卡布奇诺蛋糕	ka'bu'qi'nuo'dan'gao
卡布罗尔巴西烤肉	ka'bu'luo'er'ba'xi'kao'rou
卡拉什尼科夫伏特加	ka'la'shi'ni'ke'fu'fu'te'jia
卡拉胶	ka'la'jiao
卡滋	ka'zi
卡真调料	ka'zhen'tiao'liao
卡蕾多儿	ka'lei'duo'er
卡通蛋糕	ka'tong'dan'gao
卢氏麻片	lu'shi'ma'pian
卤子鹅	lu'zi'e
卤汁豆干	lu'zhi'dou'gan
卤牛肉	lu'niu'rou
卤瓜氽黄鱼	lu'gua'tun'huang'yu
卤米线	lu'mi'xian
卤肉豆沙酥饼	lu'rou'dou'sha'su'bing
卤蛋	lu'dan
卤豆腐	lu'dou'fu
卤面	lu'mian
卤饵丝	lu'er'si
卤饵块	lu'er'kuai
卤鸭翅	lu'ya'chi
印度奶茶	yin'du'nai'cha
即食鲍鱼	ji'shi'bao'yu
卷心菜洋葱汁	juan'xin'cai'yang'cong'zhi
卷筒蛋糕	juan'tong'dan'gao
卷粉	juan'fen
厄尔尼诺鸡尾酒	e'er'ni'nuo'ji'wei'jiu
压缩饼干	ya'suo'bing'gan
原叶冰红茶	yuan'ye'bing'hong'cha
原味烤紫菜	yuan'wei'kao'zi'cai
原味腌制料	yuan'wei'yan'zhi'liao
原壳鲍鱼	yuan'ke'bao'yu
原笼牛肉	yuan'long'niu'rou
原笼玉簪	yuan'long'yu'zan
原笼粉蒸	yuan'long'fen'zheng
厦门薄饼	xia'men'bao'bing
厦门鱼皮花生	xia'men'yu'pi'hua'sheng
厨乐玉米粒	chu'le'yu'mi'li
去皮番茄罐头	qu'pi'fan'qie'guan'tou
参果炖瘦肉	can'guo'dun'shou'rou
参芪红枣乳鸽汤	shen'qi'hong'zao'ru'ge'tang
参芪蒸猪心	shen'qi'zheng'zhu'xin
参花茶	can'hua'cha
参苓粉饼干	can'ling'fen'bing'gan
参茸茶	shen'rong'cha
参茸鸡肉汤	shen'rong'ji'rou'tang
参蒸鳝段	can'zheng'shan'duan
参麦团鱼	can'mai'tuan'yu
参麦雪梨瘦肉汤	can'mai'xue'li'shou'rou'tang
叉烤鳜鱼	cha'kao'gui'yu
叉烧炒面	cha'shao'chao'mian
叉烧猪肉	cha'shao'zhu'rou
叉烧甘露卷蛋糕	cha'shao'gan'lu'juan'dan'gao
叉烧酥	cha'shao'su
叉烧香酥	cha'shao'xiang'su
叉烧鱼	cha'shao'yu
叉烧鸡	cha'shao'ji
叉烧鸭子	cha'shao'ya'zi
叉烧鸭	cha'shao'ya
双乙酰酒石酸单甘油酯	shuang'yi'xian'jiu'shi'suan'dan'gan'you'zhi
双乙酰酒石酸双甘油酯	shuang'yi'xian'jiu'shi'suan'shuang'gan'you'zhi
双乙酸钠	shuang'yi'suan'na
双仁浮皮	shuang'ren'fu'pi
双仁猪展汤	shuang'ren'zhu'zhan'tang
双味糯米糍	shuang'wei'nuo'mi'ci
双味蹄筋	shuang'wei'ti'jin
双喜临门	shuang'xi'lin'men
双威	shuang'wei
双孢蘑菇罐头	shuang'bao'mo'gu'guan'tou
双峰	shuang'feng
双林姑嫂饼	shuang'lin'gu'sao'bing
双桥毛尖	shuang'qiao'mao'jian
双椒烘蛋	shuang'jiao'hong'dan
双椒鸡	shuang'jiao'ji
双灯牌糖果	shuang'deng'pai'tang'guo
双烤肉	shuang'kao'rou
双玫菊茶	shuang'mei'ju'cha
双皮刀鱼	shuang'pi'dao'yu
双立人	shuang'li'ren
双色核桃饼干	shuang'se'he'tao'bing'gan
双色玫瑰鱼	shuang'se'mei'gui'yu
双色糕	shuang'se'gao
双色绿茶蛋糕卷	shuang'se'lv'cha'dan'gao'juan
双色绿茶饼干	shuang'se'lv'cha'bing'gan
双色蛋菇	shuang'se'dan'gu
双色豆糕	shuang'se'dou'gao
双色马蹄糕	shuang'se'ma'ti'gao
双花饮	shuang'hua'yin
双酥饼	shuang'su'bing
双鹤	shuang'he
双麻酥饼	shuang'ma'su'bing
双黄鱼片	shuang'huang'yu'pian
反沙芋头	fan'sha'yu'tou
发丝百叶	fa'si'bai'ye
发丝百页	fa'si'bai'ye
发菜蚝豉汤	fa'cai'hao'chi'tang
发菜黄花	fa'cai'huang'hua
发财好事	fa'cai'hao'shi
发酵醋蜂蜜梅果饮料	fa'jiao'cu'feng'mi'mei'guo'yin'liao
发酵饼干	fa'jiao'bing'gan
口味蛇	kou'wei'she
口味金牛蹄	kou'wei'jin'niu'ti
口味鳝片	kou'wei'shan'pian
口味龙虾仔	kou'wei'long'xia'zai
口味	kou'wei
口感盐煎肉	kou'gan'yan'jian'rou
口水鸡	kou'shui'ji
口福鸡	kou'fu'ji
口蘑扒鱼脯	kou'mo'ba'yu'pu
口蘑蒸鸡	kou'mo'zheng'ji
口蘑鹿肉	kou'mo'lu'rou
口袋豆腐	kou'dai'dou'fu
古丈毛尖茶	gu'zhang'mao'jian'cha
古井贡	gu'jing'gong
古井	gu'jing
古劳银针	gu'lao'yin'zhen
古法扣全端	gu'fa'kou'quan'duan
古老肉	gu'lao'rou
古越龙山	gu'yue'long'shan
古钟	gu'zhong
古陈仓牌	gu'chen'cang'pai
叫化仔鸡	jiao'hua'zi'ji
叫化鸡	jiao'hua'ji
可乐鸡翅	ke'le'ji'chi
可口可乐	ke'kou'ke'le
可可咖啡	ke'ke'ka'fei
可可基	ke'ke'ji
可可壳色	ke'ke'ke'se
可可小圆蛋糕	ke'ke'xiao'yuan'dan'gao
可可果	ke'ke'guo
可可栗子糖	ke'ke'li'zi'tang
可可菠萝泡芙	ke'ke'bo'luo'pao'fu
可可蛋糕	ke'ke'dan'gao
可可麦乳精	ke'ke'mai'ru'jing
可得然胶	ke'de'ran'jiao
可浓	ke'nong
可罗酒咖啡	ke'luo'jiu'ka'fei
台式三杯鸡	tai'shi'san'bei'ji
台式卤肉酥	tai'shi'lu'rou'su
台湾瓜仔肉酱罐头	tai'wan'gua'zai'rou'jiang'guan'tou
台湾省	tai'wan'sheng
台湾老船长蕃茄汁大沙丁鱼	tai'wan'lao'chuan'zhang'fan'qie'zhi'da'sha'ding'yu
台湾青枣	tai'wan'qing'zao
台茶	tai'cha
叶儿耙	ye'er'ba
叶大昌糕点	ye'da'chang'gao'dian
叶子面包	ye'zi'mian'bao
叶绿素铜钠盐	ye'lv'su'tong'na'yan
叶绿素铜钾盐	ye'lv'su'tong'jia'yan
叶酸	ye'suan
叶醇	ye'chun
司岗里	si'gang'li
司康饼	si'kang'bing
司盘山梨醇酐单棕榈酸酯	si'pan'shan'li'chun'gan'dan'zong'lv'suan'zhi
司盘山梨醇酐单硬脂酸酯	si'pan'shan'li'chun'gan'dan'ying'zhi'suan'zhi
司陶特啤酒	si'tao'te'pi'jiu
各地糕点名	ge'di'gao'dian'ming
各地糖果罐头小食品	ge'di'tang'guo'guan'tou'xiao'shi'pin
合川桃片	he'chuan'tao'pian
合川肉片	he'chuan'rou'pian
合德堂	he'de'tang
合油酥	he'you'su
合菜盖被	he'cai'gai'bei
吉利大虾	ji'li'da'xia
吉利虾	ji'li'xia
吉安薄酥饼	ji'an'bo'su'bing
吉林省	ji'lin'sheng
吉祥干贝	ji'xiang'gan'bei
吉祥顶呱呱	ji'xiang'ding'gua'gua
同源堂	tong'yuan'tang
名酒酒心巧克力	ming'jiu'jiu'xin'qiao'ke'li
吐司	tu'si
吐温	tu'wen
吗啉脂肪酸盐果蜡	ma'lin'zhi'fang'suan'yan'guo'la
君之薇	jun'zhi'wei
君乐	jun'le
君山银针茶	jun'shan'yin'zhen'cha
君度酒咖啡	jun'du'jiu'ka'fei
吞拿鱼罐头	tun'na'yu'guan'tou
吞拿鱼	tun'na'yu
含羞丸子	han'xiu'wan'zi
含羞果	han'xiu'guo
启元	qi'yuan
启发金桂花茶饼	qi'fa'jin'gui'hua'cha'bing
吴常昌牛巴	wu'chang'chang'niu'ba
呈味核苷酸二钠	cheng'wei'he'gan'suan'er'na
周兔头	zhou'tu'tou
周口宴席套菜罐头	zhou'kou'yan'xi'tao'cai'guan'tou
周村大烧饼	zhou'cun'da'shao'bing
味付软包装罐头	wei'fu'ruan'bao'zhuang'guan'tou
味好美	wei'hao'mei
味源	wei'yuan
味滋源高档鸡精	wei'zi'yuan'gao'dang'ji'jing
味精香糕	wei'jing'xiang'gao
和其正	he'qi'zheng
和菜罐头	he'cai'guan'tou
和风玉子烧	he'feng'yu'zi'shao
咕咕霍夫	gu'gu'huo'fu
咕噜牛排	gu'lu'niu'pai
咕噜肉	gu'lu'rou
咖仁辣红粉	ka'ren'la'hong'fen
咖哩牛肉	ka'li'niu'rou
咖哩草菇	ka'li'cao'gu
咖哩鸡	ka'li'ji
咖啡因	ka'fei'yin
咖啡小蛋糕	ka'fei'xiao'dan'gao
咖啡榛子蛋糕	ka'fei'zhen'zi'dan'gao
咖啡欧蕾	ka'fei'ou'lei
咖啡糖	ka'fei'tang
咖啡蛋糕卷	ka'fei'dan'gao'juan
咖啡豆	ka'fei'dou
咖喱大豆烩肉	ga'li'da'dou'hui'rou
咖喱樱桃	ga'li'ying'tao
咖喱炒干丝	ga'li'chao'gan'si
咖喱焖鸡	ga'li'men'ji
咖喱牛排	ga'li'niu'pai
咖喱牛肉擘酥	ga'li'niu'rou'bo'su
咖喱牛肉饺	ga'li'niu'rou'jiao
咖喱牛肉	ga'li'niu'rou
咖喱粉	ga'li'fen
咖喱腌制料	ga'li'yan'zhi'liao
咖喱菜花	ga'li'cai'hua
咖喱饺	ga'li'jiao
咖喱鸡丝羹	ga'li'ji'si'geng
咖喱	ga'li
咸味奶油糖	xian'wei'nai'you'tang
咸宁桂花糕	xian'ning'gui'hua'gao
咸烧白	xian'shao'bai
咸真酥	xian'zhen'su
咸菜鸭	xian'cai'ya
咸蛋节瓜鱼尾汤	xian'dan'jie'gua'yu'wei'tang
咸蛋蒸肉饼	xian'dan'zheng'rou'bing
咸金枣	xian'jin'zao
咸鱼茄子煲	xian'yu'qie'zi'bao
咸鱼锅子	xian'yu'guo'zi
咸鱼鸡粒煮豆腐	xian'yu'ji'li'zhu'dou'fu
品秀牌	pin'xiu'pai
哈密瓜汁罐头	ha'mi'gua'zhi'guan'tou
哈密瓜	ha'mi'gua
哈尔滨面包	ha'er'bin'mian'bao
哈特啤酒	ha'te'pi'jiu
哈达饼	ha'da'bing
响铃海参	xiang'ling'hai'shen
响铃球	xiang'ling'qiu
响铃肉圆	xiang'ling'rou'yuan
哥伦比亚咖啡	ge'lun'bi'ya'ka'fei
商芝肉	shang'zhi'rou
啤酒椒麻鸡	pi'jiu'jiao'ma'ji
啫喱冻苹果杯	zhe'li'dong'ping'guo'bei
喜品	xi'pin
喜年来食品	xi'nian'lai'shi'pin
喜庆花糕	xi'qing'hua'gao
喜歪歪	xi'wai'wai
喜洲鱼	xi'zhou'yu
喜立	xi'li
喜鹊登枝	xi'que'deng'zhi
喷火林宝坚尼	pen'huo'lin'bao'jian'ni
喹啉黄	kui'lin'huang
嘉吉	jia'ji
嘉骏	jia'jun
噻苯咪唑	sai'ben'mi'zuo
四味山药膏	si'wei'shan'yao'gao
四喜丸子	si'xi'wan'zi
四喜福袋	si'xi'fu'dai
四喜饺	si'xi'jiao
四喜鱼卷	si'xi'yu'juan
四喜鸭子	si'xi'ya'zi
四喜黄豆粒	si'xi'huang'dou'li
四季宝柔滑花生酱	si'ji'bao'rou'hua'hua'sheng'jiang
四宝上汤	si'bao'shang'tang
四宝甘笋糕	si'bao'gan'sun'gao
四川泡大蒜	si'chuan'pao'da'suan
四川泡菜	si'chuan'pao'cai
四川灯草糕	si'chuan'deng'cao'gao
四川省	si'chuan'sheng
四川辣子鸡	si'chuan'la'zi'ji
四样荤素	si'yang'hun'su
四神煲豆腐	si'shen'bao'dou'fu
四色冰皮月饼	si'se'bing'pi'yue'bing
四鲜烤麸罐头	si'xian'kao'fu'guan'tou
四鲜烤麸	si'xian'kao'fu
四鲜白菜墩	si'xian'bai'cai'dun
回味香黑鸭	hui'wei'xiang'hei'ya
回味鱼片	hui'wei'yu'pian
回锅牛小排	hui'guo'niu'xiao'pai
回锅肉	hui'guo'rou
回锅鱼片	hui'guo'yu'pian
团圆汤	tuan'yuan'tang
围炉火锅	wei'lu'huo'guo
固体乳胶	gu'ti'ru'jiao
固体山楂饮料	gu'ti'shan'zha'yin'liao
固定化葡萄糖异构酶制剂	gu'ding'hua'pu'tao'tang'yi'gou'mei'zhi'ji
国林	guo'lin
国树	guo'shu
国珍	guo'zhen
圆白菜炒腊肉	yuan'bai'cai'chao'la'rou
圆肉杞子炖鲍鱼	yuan'rou'qi'zi'dun'bao'yu
圆肉花生排骨汤	yuan'rou'hua'sheng'pai'gu'tang
圆蛋糕	yuan'dan'gao
圆黄蛋糕	yuan'huang'dan'gao
土沱麻饼	tu'tuo'ma'bing
土耳其咖啡	tu'er'qi'ka'fei
土茯苓炖猪肉	tu'fu'ling'dun'zhu'rou
土豆排骨汤	tu'dou'pai'gu'tang
土豆松糕	tu'dou'song'gao
土豆松饼脆奶	tu'dou'song'bing'cui'nai
土豆泥	tu'dou'ni
土豆炖牛肉	tu'dou'dun'niu'rou
土豆烧排骨	tu'dou'shao'pai'gu
土豆烧肉	tu'dou'shao'rou
土豆粑粑	tu'dou'ba'ba
土豆罐焖鸡	tu'dou'guan'men'ji
土豆蛋糕	tu'dou'dan'gao
土豆饼	tu'dou'bing
圣嘉	sheng'jia
圣堡罗	sheng'bao'luo
圣奥清真原汁牛尾罐头	sheng'ao'qing'zhen'yuan'zhi'niu'wei'guan'tou
圣女果	sheng'nv'guo
圣杞乐	sheng'qi'le
圣艾吉尼系列	sheng'ai'ji'ni'xi'lie
圣诞布丁	sheng'dan'bu'ding
圣诞老人蛋糕	sheng'dan'lao'ren'dan'gao
圣诞面包	sheng'dan'mian'bao
在家做蛋糕	zai'jia'zuo'dan'gao
地三鲜	di'san'xian
地扪菠菜叶	di'men'bo'cai'ye
地栗糕	di'li'gao
地王上岛咖啡	di'wang'shang'dao'ka'fei
地王	di'wang
地瓜糖	di'gua'tang
地瓜饼	di'gua'bing
地胆头炖猪月展	di'dan'tou'dun'zhu'yue'zhan
均质豆浆	jun'zhi'dou'jiang
坚果蛋糕	jian'guo'dan'gao
坛子肉	tan'zi'rou
坦洋工夫茶	tan'yang'gong'fu'cha
垫江豆花	dian'jiang'dou'hua
城隍庙五香豆	cheng'huang'miao'wu'xiang'dou
培养正气鸡块	pei'yang'zheng'qi'ji'kuai
培根松仁饼干	pei'gen'song'ren'bing'gan
培根火腿	pei'gen'huo'tui
培根蔬菜卷	pei'gen'shu'cai'juan
培根面包	pei'gen'mian'bao
培根	pei'gen
基摩	ji'mo
基斯乐	ji'si'le
基本戚风蛋糕	ji'ben'qi'feng'dan'gao
堡马庄园	bao'ma'zhuang'yuan
塔比的假日	ta'bi'de'jia'ri
塔牌	ta'pai
塞上香哪	sai'shang'xiang'na
塞外酒堡	sai'wai'jiu'bao
增味剂	zeng'wei'ji
增稠剂	zeng'chou'ji
墨子酥	mo'zi'su
墨西哥日落冰咖啡	mo'xi'ge'ri'luo'bing'ka'fei
墨西哥水饺片	mo'xi'ge'shui'jiao'pian
墨鱼香菇冬笋粥	mo'yu'xiang'gu'dong'sun'zhou
墨鱼	mo'yu
士干皮	shi'gan'pi
壬内酯	ren'nei'zhi
壬酸乙酯	ren'suan'yi'zhi
壮家凉茶	zhuang'jia'liang'cha
壳聚糖	ke'ju'tang
复元汤	fu'yuan'tang
复原乳	fu'yuan'ru
复盆子酮	fu'pen'zi'tong
夏威夷冰咖啡	xia'wei'yi'bing'ka'fei
夏威夷果	xia'wei'yi'guo
外婆大品碗	wai'po'da'pin'wan
外婆家醉鱼	wai'po'jia'zui'yu
多佳	duo'jia
多味果	duo'wei'guo
多味黄瓜	duo'wei'huang'gua
多喝水	duo'he'shui
多彩冰皮月饼	duo'cai'bing'pi'yue'bing
多彩南瓜饭盅	duo'cai'nan'gua'fan'zhong
多提诺	duo'ti'nuo
多穗柯棕	duo'sui'ke'zong
夜光杯	ye'guang'bei
夜郎府	ye'lang'fu
夜香冬瓜盅	ye'xiang'dong'gua'zhong
大东寒武泉牌	da'dong'han'wu'quan'pai
大佛白龙井	da'fo'bai'long'jing
大包白薯粉丝箱绿源	da'bao'bai'shu'fen'si'xiang'lv'yuan
大千子鸡	da'qian'zi'ji
大华酥饼	da'hua'su'bing
大卫杜夫	da'wei'du'fu
大厨来桂林辣椒酱	da'chu'lai'gui'lin'la'jiao'jiang
大厨来海鲜酱	da'chu'lai'hai'xian'jiang
大厨来蒜蓉辣椒酱	da'chu'lai'suan'rong'la'jiao'jiang
大厨来蜜汁烤肉酱	da'chu'lai'mi'zhi'kao'rou'jiang
大厨来豆瓣酱	da'chu'lai'dou'ban'jiang
大叶乌龙	da'ye'wu'long
大叶枣	da'ye'zao
大叶苦茶	da'ye'ku'cha
大团圆	da'tuan'yuan
大围山蒸方肉	da'wei'shan'zheng'fang'rou
大富豪	da'fu'hao
大山合牌	da'shan'he'pai
大山牌	da'shan'pai
大峡谷	da'xia'gu
大救驾	da'jiu'jia
大方糕	da'fang'gao
大有水绿豆糕	da'you'shui'lv'dou'gao
大朴	da'pu
大枣冬菇汤	da'zao'dong'gu'tang
大枣姜汤	da'zao'jiang'tang
大枣百合汤	da'zao'bai'he'tang
大树菠萝	da'shu'bo'luo
大理石芝士条	da'li'shi'zhi'shi'tiao
大理石芝士蛋糕	da'li'shi'zhi'shi'dan'gao
大理石蛋糕	da'li'shi'dan'gao
大理砂锅鱼	da'li'sha'guo'yu
大理雪梨	da'li'xue'li
大理雪茶	da'li'xue'cha
大白兔奶糖	da'bai'tu'nai'tang
大白菜水饺	da'bai'cai'shui'jiao
大盘肚	da'pan'du
大盘鸡	da'pan'ji
大石四季仔	da'shi'si'ji'zai
大米蛋糕	da'mi'dan'gao
大红枣露	da'hong'zao'lu
大红袍	da'hong'pao
大肉	da'rou
大肠生炒咸酸菜	da'chang'sheng'chao'xian'suan'cai
大花蛋糕	da'hua'dan'gao
大茴香醛	da'hui'xiang'quan
大荔带把肘子	da'li'dai'ba'zhou'zi
大蒜干贝	da'suan'gan'bei
大蒜鲇鱼	da'suan'nian'yu
大蒜鲶鱼	da'suan'nian'yu
大蛋散	da'dan'san
大豆磷脂	da'dou'lin'zhi
大蹄扒海参	da'ti'ba'hai'shen
大边炉	da'bian'lu
大雪枣	da'xue'zao
大面白	da'mian'bai
大鱼头豆腐汤	da'yu'tou'dou'fu'tang
大鸡汁	da'ji'zhi
大麦茶饮料	da'mai'cha'yin'liao
大麻球	da'ma'qiu
大黄消脂绿豆汤	da'huang'xiao'zhi'lv'dou'tang
天下第一包	tian'xia'di'yi'bao
天人有机	tian'ren'you'ji
天仁	tian'ren
天使蛋糕	tian'shi'dan'gao
天使蜜豆蛋糕	tian'shi'mi'dou'dan'gao
天冬蜜饯	tian'dong'mi'jian
天合耗儿鱼	tian'he'hao'er'yu
天天好食	tian'tian'hao'shi
天山烘绿	tian'shan'hong'lv
天府花生酥糖	tian'fu'hua'sheng'su'tang
天府花生	tian'fu'hua'sheng
天果	tian'guo
天津包子	tian'jin'bao'zi
天津宫饼	tian'jin'gong'bing
天津市	tian'jin'shi
天津糕条	tian'jin'gao'tiao
天湖凤片	tian'hu'feng'pian
天然果蔬饮料	tian'ran'guo'shu'yin'liao
天然橡胶	tian'ran'xiang'jiao
天然苋菜红	tian'ran'xian'cai'hong
天然薄荷脑	tian'ran'bo'he'nao
天目烘青豆	tian'mu'hong'qing'dou
天目笋干	tian'mu'sun'gan
天目青顶茶	tian'mu'qing'ding'cha
天目青项茶	tian'mu'qing'xiang'cha
天红宝	tian'hong'bao
天门冬氨酸	tian'men'dong'an'suan
天门冬酰胺酶	tian'men'dong'xian'an'mei
天门冬酰苯氨酸甲酯	tian'men'dong'xian'ben'an'suan'jia'zhi
天麻全鸡	tian'ma'quan'ji
天麻汽锅鸡	tian'ma'qi'guo'ji
天麻酒	tian'ma'jiu
天麻钩藤粥	tian'ma'gou'teng'zhou
天麻鱼头汤	tian'ma'yu'tou'tang
天麻鲍鱼汤	tian'ma'bao'yu'tang
天麻	tian'ma
太史饼	tai'shi'bing
太和桃脯	tai'he'tao'pu
太子参无花果瘦肉汤	tai'zi'shen'wu'hua'guo'shou'rou'tang
太子奶	tai'zi'nai
太子麦蕉	tai'zi'mai'jiao
太平猴魁绿茶	tai'ping'hou'kui'lv'cha
太平猴魁茶	tai'ping'hou'kui'cha
太极双丝	tai'ji'shuang'si
太极双泥	tai'ji'shuang'ni
太极干巴菌	tai'ji'gan'ba'jun
太极芋头	tai'ji'yu'tou
太极鱼翅	tai'ji'yu'chi
太爷鸡	tai'ye'ji
太白庄园	tai'bai'zhuang'yuan
太白鸭	tai'bai'ya
太谷饼	tai'gu'bing
太阳玉米粒	tai'yang'yu'mi'li
太阳糕	tai'yang'gao
太阳饼	tai'yang'bing
太阳	tai'yang
夫妻肺片	fu'qi'fei'pian
夹心柿饼	jia'xin'shi'bing
夹心蒸蛋糕	jia'xin'zheng'dan'gao
夹心虾糕	jia'xin'xia'gao
夹心饼干	jia'xin'bing'gan
夹沙月饼	jia'sha'yue'bing
夹沙条头糕	jia'sha'tiao'tou'gao
夹沙煎饼	jia'sha'jian'bing
奇力元	qi'li'yuan
奇味干锅	qi'wei'gan'guo
奇味酱	qi'wei'jiang
奇异天空	qi'yi'tian'kong
奇异果弥猴桃	qi'yi'guo'mi'hou'tao
奇异果煎虾沙拉	qi'yi'guo'jian'xia'sha'la
奇异果篮	qi'yi'guo'lan
奇异果	qi'yi'guo
奇斯多拉香肠	qi'si'duo'la'xiang'chang
奉化摇蜡	feng'hua'yao'la
奎宁水	kui'ning'shui
套四宝	tao'si'bao
奥德曼	ao'de'man
奥花冰花酸梅酱	ao'hua'bing'hua'suan'mei'jiang
奥花大红浙醋	ao'hua'da'hong'zhe'cu
奥莱咖啡	ao'lai'ka'fei
女贞子酒	nv'zhen'zi'jiu
奶味芦笋汤	nai'wei'lu'sun'tang
奶层糕	nai'ceng'gao
奶汁回王鱼	nai'zhi'hui'wang'yu
奶汤元鱼	nai'tang'yuan'yu
奶汤八宝布袋鸡	nai'tang'ba'bao'bu'dai'ji
奶汤散丹	nai'tang'san'dan
奶汤火腿大鱼头	nai'tang'huo'tui'da'yu'tou
奶汤白菜	nai'tang'bai'cai
奶汤蒲菜	nai'tang'pu'cai
奶汤面	nai'tang'mian
奶汤鲜核桃仁	nai'tang'xian'he'tao'ren
奶汤鸡脯	nai'tang'ji'pu
奶汤	nai'tang
奶油乳酪司康	nai'you'ru'lao'si'kang
奶油乳酪蛋糕	nai'you'ru'lao'dan'gao
奶油卷蛋糕	nai'you'juan'dan'gao
奶油可口蛋糕	nai'you'ke'kou'dan'gao
奶油可可慕斯蛋糕	nai'you'ke'ke'mu'si'dan'gao
奶油小蛋糕	nai'you'xiao'dan'gao
奶油小饼干	nai'you'xiao'bing'gan
奶油扒菜芯	nai'you'ba'cai'xin
奶油曲奇饼	nai'you'qu'qi'bing
奶油条酥	nai'you'tiao'su
奶油核桃糕	nai'you'he'tao'gao
奶油桂鱼	nai'you'gui'yu
奶油桃式点心	nai'you'tao'shi'dian'xin
奶油泡芙	nai'you'pao'fu
奶油炸糕	nai'you'zha'gao
奶油烤菠萝什锦	nai'you'kao'bo'luo'shi'jin
奶油燕窝酥	nai'you'yan'wo'su
奶油玉米笋	nai'you'yu'mi'sun
奶油球糖和荔枝硬糖	nai'you'qiu'tang'he'li'zhi'ying'tang
奶油瓜菇汤	nai'you'gua'gu'tang
奶油生菜	nai'you'sheng'cai
奶油白酱	nai'you'bai'jiang
奶油芝士	nai'you'zhi'shi
奶油花生米	nai'you'hua'sheng'mi
奶油花生糖	nai'you'hua'sheng'tang
奶油花蛋糕	nai'you'hua'dan'gao
奶油草莓蛋糕	nai'you'cao'mei'dan'gao
奶油莲花白	nai'you'lian'hua'bai
奶油菠萝冻	nai'you'bo'luo'dong
奶油蛋糕	nai'you'dan'gao
奶油蟹肉	nai'you'xie'rou
奶油西兰花	nai'you'xi'lan'hua
奶油起酥排	nai'you'qi'su'pai
奶油风轮酥	nai'you'feng'lun'su
奶油黄金饼	nai'you'huang'jin'bing
奶泡咖啡	nai'pao'ka'fei
奶白鲫鱼汤	nai'bai'ji'yu'tang
奶酪蛋糕	nai'lao'dan'gao
奶酪软糖	nai'lao'ruan'tang
奶香玉米饼	nai'xiang'yu'mi'bing
奶香菠菜	nai'xiang'bo'cai
奶黄冰皮月饼	nai'huang'bing'pi'yue'bing
奶黄雪梨果	nai'huang'xue'li'guo
奶黄雪蛤酥	nai'huang'xue'ha'su
好丝百叶	hao'si'bai'ye
好乐门奶香沙拉酱	hao'le'men'nai'xiang'sha'la'jiang
好乐门纯正蛋黄酱	hao'le'men'chun'zheng'dan'huang'jiang
好乐门蛋黄酱	hao'le'men'dan'huang'jiang
好吃来瓜子	hao'chi'lai'gua'zi
好味鸡	hao'wei'ji
好胃到	hao'wei'dao
如意乌龙	ru'yi'wu'long
如意卷	ru'yi'juan
如意竹荪	ru'yi'zhu'sun
如意酥	ru'yi'su
如皋董糖	ru'gao'dong'tang
妈妈蔬菜蛋卷	ma'ma'shu'cai'dan'juan
姜丝焗肉蟹	jiang'si'ju'rou'xie
姜丝牛肉	jiang'si'niu'rou
姜丝肉蟹	jiang'si'rou'xie
姜乳蒸饼	jiang'ru'zheng'bing
姜味甜饼	jiang'wei'tian'bing
姜味蛋糕	jiang'wei'dan'gao
姜汁仔鸡	jiang'zhi'zi'ji
姜汁刀豆	jiang'zhi'dao'dou
姜汁啤酒	jiang'zhi'pi'jiu
姜汁扁豆	jiang'zhi'bian'dou
姜汁拌菠菜	jiang'zhi'ban'bo'cai
姜汁排叉儿	jiang'zhi'pai'cha'er
姜汁热味鸡	jiang'zhi're'wei'ji
姜汁热窝鸡	jiang'zhi're'wo'ji
姜汁菠菜	jiang'zhi'bo'cai
姜汁赤贝	jiang'zhi'chi'bei
姜汁饼	jiang'zhi'bing
姜汁鸭掌	jiang'zhi'ya'zhang
姜油	jiang'you
姜爆三丝	jiang'bao'san'si
姜爆鸭丝	jiang'bao'ya'si
姜糖	jiang'tang
姜茶乌梅粥	jiang'cha'wu'mei'zhou
姜茸柠檬锔鸡腿	jiang'rong'ning'meng'ju'ji'tui
姜葱基围虾	jiang'cong'ji'wei'xia
姜葱炒蟹	jiang'cong'chao'xie
姜葱煀鲤鱼	jiang'cong'kuo'li'yu
姜葱螃蟹	jiang'cong'pang'xie
姜葱蟹煲	jiang'cong'xie'bao
姜黄粉	jiang'huang'fen
姜黄素	jiang'huang'su
姜黄	jiang'huang
姬松茸	ji'song'rong
威化饼干	wei'hua'bing'gan
威士忌库勒	wei'shi'ji'ku'le
威士忌苏打	wei'shi'ji'su'da
威士忌	wei'shi'ji
威宁荞酥	wei'ning'qiao'su
威尼斯黑蛋糕	wei'ni'si'hei'dan'gao
威林	wei'lin
威肉月饼	wei'rou'yue'bing
威臣	wei'chen
娃哈哈	wa'ha'ha
婚庆蛋糕	hun'qing'dan'gao
婚礼蛋糕	hun'li'dan'gao
婺州东白茶	wu'zhou'dong'bai'cha
婺州举岩	wu'zhou'ju'yan
婺源茗眉茶	wu'yuan'ming'mei'cha
婺绿	wu'lv
嫦娥奔月饼	chang'e'ben'yue'bing
嫩肉粉	nen'rou'fen
嫩豇豆汤	nen'jiang'dou'tang
子姜鸭	zi'jiang'ya
孔府一品锅	kong'fu'yi'pin'guo
孔府家	kong'fu'jia
孜然炒菠菜	zi'ran'chao'bo'cai
孜然腌制料	zi'ran'yan'zhi'liao
孜然	zi'ran
孝感麻糖	xiao'gan'ma'tang
宁乡蜜饯	ning'xiang'mi'jian
宁强王家核桃饼	ning'qiang'wang'jia'he'tao'bing
宁氏鳝丝	ning'shi'shan'si
宁波豆酥糖	ning'bo'dou'su'tang
宁海望海茶	ning'hai'wang'hai'cha
宁红茶	ning'hong'cha
安全地带	an'quan'di'dai
安全海滩性爱	an'quan'hai'tan'xing'ai
安化松针	an'hua'song'zhen
安定堡	an'ding'bao
安富丽	an'fu'li
安康米酒	an'kang'mi'jiu
安德劳斯兄弟	an'de'lao'si'xiong'di
安徽省	an'hui'sheng
安徽菜	an'hui'cai
安息茴香籽孜然	an'xi'hui'xiang'zi'zi'ran
安格斯	an'ge'si
安答	an'da
安赛蜜	an'sai'mi
安阳三熏	an'yang'san'xun
宋嫂鱼羹	song'sao'yu'geng
官燕红枣奶酪	guan'yan'hong'zao'nai'lao
定海芽尖	ding'hai'ya'jian
定胜糕	ding'sheng'gao
定边羊羔肉	ding'bian'yang'gao'rou
宜宾燃面	yi'bin'ran'mian
宜红茶	yi'hong'cha
宜良烤鸭	yi'liang'kao'ya
宜芝多的烤芝士	yi'zhi'duo'de'kao'zhi'shi
宝宝桔汁	bao'bao'ju'zhi
宝宝福	bao'bao'fu
宝矿力饮料	bao'kuang'li'yin'liao
宝箭欧洲杯	bao'jian'ou'zhou'bei
宝箱豆腐	bao'xiang'dou'fu
宝鸡茶酥	bao'ji'cha'su
客家封鸡	ke'jia'feng'ji
客家酿豆腐	ke'jia'niang'dou'fu
宣城蜜枣	xuan'cheng'mi'zao
宣威土豆	xuan'wei'tu'dou
宣威大土豆	xuan'wei'da'tu'dou
宣威大洋芋	xuan'wei'da'yang'yu
宣威洋芋	xuan'wei'yang'yu
宣威火腿	xuan'wei'huo'tui
宫保兔肉	gong'bao'tu'rou
宫保虾球	gong'bao'xia'qiu
宫保魔芋豆腐	gong'bao'mo'yu'dou'fu
宫保鸡丁	gong'bao'ji'ding
宫保鸡	gong'bao'ji
宫保鹌鹑	gong'bao'an'chun
宫庭献鱼	gong'ting'xian'yu
宫廷小窝头	gong'ting'xiao'wo'tou
宫廷排翅	gong'ting'pai'chi
宫廷风味糕点	gong'ting'feng'wei'gao'dian
宫灯鱼丝	gong'deng'yu'si
宫饼	gong'bing
家乐安多夫天然松肉粉	jia'le'an'duo'fu'tian'ran'song'rou'fen
家乐番茄沙司	jia'le'fan'qie'sha'si
家乐粟粉	jia'le'su'fen
家乐香浓鸡精粉	jia'le'xiang'nong'ji'jing'fen
家乐鲜露	jia'le'xian'lu
家乐鸡粉	jia'le'ji'fen
家乐鸡精	jia'le'ji'jing
家乐黑胡椒汁	jia'le'hei'hu'jiao'zhi
家乡南肉	jia'xiang'nan'rou
家乡肉	jia'xiang'rou
家乡芝士蛋糕	jia'xiang'zhi'shi'dan'gao
家常旺	jia'chang'wang
家常海参	jia'chang'hai'shen
家常炒面	jia'chang'chao'mian
家常烤鸡	jia'chang'kao'ji
家常熬鱼	jia'chang'ao'yu
家常豆腐	jia'chang'dou'fu
家常鸡块	jia'chang'ji'kuai
容美茶	rong'mei'cha
宿松雪枣	su'song'xue'zao
密汁南瓜	mi'zhi'nan'gua
密蒙黄	mi'meng'huang
富万利	fu'wan'li
富川蜜枣	fu'chuan'mi'zao
富平太后饼	fu'ping'tai'hou'bing
富春江鲥鱼	fu'chun'jiang'shi'yu
富春鸡	fu'chun'ji
富油包	fu'you'bao
富硒酵母	fu'xi'jiao'mu
富贵手撕鸡	fu'gui'shou'si'ji
富贵有鱼	fu'gui'you'yu
富贵黄金卷	fu'gui'huang'jin'juan
富阳板粟	fu'yang'ban'su
富马酸亚铁	fu'ma'suan'ya'tie
富马酸	fu'ma'suan
寡妇之吻	gua'fu'zhi'wen
寸金	cun'jin
对羟基苯甲酸丙酯钠	dui'qiang'ji'ben'jia'suan'bing'zhi'na
对羟基苯甲酸乙酯	dui'qiang'ji'ben'jia'suan'yi'zhi
对羟基苯甲酸甲酯钠	dui'qiang'ji'ben'jia'suan'jia'zhi'na
对羟基苯甲酸酯	dui'qiang'ji'ben'jia'suan'zhi
寿星桔蜜饯	shou'xing'ju'mi'jian
寿翁素	shou'weng'su
射雕英雄	she'diao'ying'xiong
尊尼沃加	zun'ni'wo'jia
尊尼萨达	zun'ni'sa'da
小凤饼	xiao'feng'bing
小卷粉	xiao'juan'fen
小圆面包	xiao'yuan'mian'bao
小天鹅	xiao'tian'e
小媳妇串串香	xiao'xi'fu'chuan'chuan'xiang
小孩酥糖	xiao'hai'su'tang
小巧火腿酥	xiao'qiao'huo'tui'su
小扁豆	xiao'bian'dou
小方火腿	xiao'fang'huo'tui
小林黄姜	xiao'lin'huang'jiang
小桃园煨汤	xiao'tao'yuan'wei'tang
小桃酥	xiao'tao'su
小火煮	xiao'huo'zhu
小炒螃蟹	xiao'chao'pang'xie
小煎仔鸡	xiao'jian'zi'ji
小煎鸡	xiao'jian'ji
小熊饼干	xiao'xiong'bing'gan
小猫脚	xiao'mao'jiao
小甜甜	xiao'tian'tian
小红头	xiao'hong'tou
小羊羹	xiao'yang'geng
小肚儿	xiao'du'er
小脑壳烧烤	xiao'nao'ke'shao'kao
小芝麻饼	xiao'zhi'ma'bing
小茴香	xiao'hui'xiang
小茶糕	xiao'cha'gao
小葱烧财鱼	xiao'cong'shao'cai'yu
小葱芝麻饼	xiao'cong'zhi'ma'bing
小蒸包	xiao'zheng'bao
小西米	xiao'xi'mi
小豆糕	xiao'dou'gao
小豆羹	xiao'dou'geng
小酒馆	xiao'jiu'guan
小鸡酥	xiao'ji'su
小麦啤酒	xiao'mai'pi'jiu
小麦草蛋挞	xiao'mai'cao'dan'ta
小黄玉	xiao'huang'yu
小黑子	xiao'hei'zi
尖椒兔	jian'jiao'tu
尖椒炒蛋	jian'jiao'chao'dan
尖椒耗儿鱼	jian'jiao'hao'er'yu
尖椒肉丝	jian'jiao'rou'si
尖椒鸡	jian'jiao'ji
尖蜜拉	jian'mi'la
尤克力	you'ke'li
屯溪醉蟹	tun'xi'zui'xie
屯绿	tun'lv
山东省	shan'dong'sheng
山东菜丸	shan'dong'cai'wan
山东菜肉丸	shan'dong'cai'rou'wan
山东菜	shan'dong'cai
山之韵	shan'zhi'yun
山城棒棒鸡	shan'cheng'bang'bang'ji
山城第一腿	shan'cheng'di'yi'tui
山大皇	shan'da'huang
山峡风味烤鱼	shan'xia'feng'wei'kao'yu
山嵛酸硬脂酸	shan'yu'suan'ying'zhi'suan
山核桃	shan'he'tao
山梨糖醇	shan'li'tang'chun
山梨酸钾	shan'li'suan'jia
山梨酸	shan'li'suan
山梨醇酐三硬脂酸酯	shan'li'chun'gan'san'ying'zhi'suan'zhi
山梨醇酐单月桂酸酯	shan'li'chun'gan'dan'yue'gui'suan'zhi
山梨醇酐单棕榈酸酯	shan'li'chun'gan'dan'zong'lv'suan'zhi
山梨醇酐单油酸酯	shan'li'chun'gan'dan'you'suan'zhi
山梨醇酐单硬脂酸酯	shan'li'chun'gan'dan'ying'zhi'suan'zhi
山楂云卷糕	shan'zha'yun'juan'gao
山楂凉茶	shan'zha'liang'cha
山楂合欢粥	shan'zha'he'huan'zhou
山楂果	shan'zha'guo
山楂核桃茶	shan'zha'he'tao'cha
山楂水	shan'zha'shui
山楂牛肉干	shan'zha'niu'rou'gan
山楂肉干	shan'zha'rou'gan
山楂荷叶茶	shan'zha'he'ye'cha
山楂迷迭香茶	shan'zha'mi'die'xiang'cha
山楂饴糖	shan'zha'yi'tang
山楂马蹄糕	shan'zha'ma'ti'gao
山毛榉坚果	shan'mao'ju'jian'guo
山泥子	shan'ni'zi
山竹	shan'zhu
山药果汁牛奶	shan'yao'guo'zhi'niu'nai
山药桂圆炖甲鱼	shan'yao'gui'yuan'dun'jia'yu
山药炒虾仁	shan'yao'chao'xia'ren
山药炸鸭翅	shan'yao'zha'ya'chi
山药点心	shan'yao'dian'xin
山药煮豆腐	shan'yao'zhu'dou'fu
山药甜汤	shan'yao'tian'tang
山药百合大枣粥	shan'yao'bai'he'da'zao'zhou
山药绿豆粥	shan'yao'lv'dou'zhou
山药蒸鲫鱼	shan'yao'zheng'ji'yu
山药薏仁茯苓粳米粥	shan'yao'yi'ren'fu'ling'jing'mi'zhou
山药鲫鱼豆腐汤	shan'yao'ji'yu'dou'fu'tang
山西省	shan'xi'sheng
山霉	shan'mei
山鸡	shan'ji
山黄皮系列糖果	shan'huang'pi'xi'lie'tang'guo
岐山挂面	qi'shan'gua'mian
岐山臊子面	qi'shan'sao'zi'mian
岐山臊子麺	qi'shan'sao'zi'mian
岐山锅盔	qi'shan'guo'kui
岐山面皮	qi'shan'mian'pi
岚韵雅	lan'yun'ya
岛山米糖	dao'shan'mi'tang
岭南酥皮	ling'nan'su'pi
岱西水葡萄	dai'xi'shui'pu'tao
岱西白洋酥	dai'xi'bai'yang'su
岱西香瓜子	dai'xi'xiang'gua'zi
岱西黑洋酥	dai'xi'hei'yang'su
岳南泡糖	yue'nan'pao'tang
岳南薄脆	yue'nan'bao'cui
峡州碧峰茶	xia'zhou'bi'feng'cha
峨眉糕	e'mei'gao
峨秀糕	e'xiu'gao
峨蕊茶	e'rui'cha
崂山啤酒	lao'shan'pi'jiu
崂山矿啤	lao'shan'kuang'pi
崂山矿泉水和崂山可乐	lao'shan'kuang'quan'shui'he'lao'shan'ke'le
崂山	lao'shan
嵌桃麻糕	qian'tao'ma'gao
巍山蜜饯	wei'shan'mi'jian
川冬菜炒鲜蚕豆	chuan'dong'cai'chao'xian'can'dou
川味水煮肉片	chuan'wei'shui'zhu'rou'pian
川味牛肉	chuan'wei'niu'rou
川味糯米饭	chuan'wei'nuo'mi'fan
川味豆卷	chuan'wei'dou'juan
川味饺子	chuan'wei'jiao'zi
川断	chuan'duan
川椒龙凤球	chuan'jiao'long'feng'qiu
川红茶	chuan'hong'cha
川芎茶	chuan'xiong'cha
川花竹笼纸箱豆瓣	chuan'hua'zhu'long'zhi'xiang'dou'ban
川花纸筒豆瓣	chuan'hua'zhi'tong'dou'ban
川花防盖红油豆瓣	chuan'hua'fang'gai'hong'you'dou'ban
川菜回锅肉	chuan'cai'hui'guo'rou
川西肉豆腐	chuan'xi'rou'dou'fu
川贝柠檬李	chuan'bei'ning'meng'li
川贝母海蜇瘦肉汤	chuan'bei'mu'hai'zhe'shou'rou'tang
川贝炖梨	chuan'bei'dun'li
川贝炖鹧鸪	chuan'bei'dun'zhe'gu
川贝酿梨	chuan'bei'niang'li
川贝雪梨猪肺汤	chuan'bei'xue'li'zhu'fei'tang
川辣黄瓜	chuan'la'huang'gua
川香风味腌制料	chuan'xiang'feng'wei'yan'zhi'liao
川鱼头火锅	chuan'yu'tou'huo'guo
巧克力冰糕	qiao'ke'li'bing'gao
巧克力刺猬	qiao'ke'li'ci'wei
巧克力双色夹心糕	qiao'ke'li'shuang'se'jia'xin'gao
巧克力夹心蛋糕	qiao'ke'li'jia'xin'dan'gao
巧克力奇普	qiao'ke'li'qi'pu
巧克力奶油夹蛋糕	qiao'ke'li'nai'you'jia'dan'gao
巧克力奶茶	qiao'ke'li'nai'cha
巧克力奶	qiao'ke'li'nai
巧克力小蛋糕	qiao'ke'li'xiao'dan'gao
巧克力布朗尼	qiao'ke'li'bu'lang'ni
巧克力慕斯	qiao'ke'li'mu'si
巧克力拉花饼干	qiao'ke'li'la'hua'bing'gan
巧克力收蛋泡盏	qiao'ke'li'shou'dan'pao'zhan
巧克力无花果球	qiao'ke'li'wu'hua'guo'qiu
巧克力汽酒	qiao'ke'li'qi'jiu
巧克力沙司	qiao'ke'li'sha'si
巧克力泡芙	qiao'ke'li'pao'fu
巧克力派	qiao'ke'li'pai
巧克力爆米花	qiao'ke'li'bao'mi'hua
巧克力牛油蛋糕	qiao'ke'li'niu'you'dan'gao
巧克力玛德琳	qiao'ke'li'ma'de'lin
巧克力甜甜圈	qiao'ke'li'tian'tian'quan
巧克力芝士蛋糕	qiao'ke'li'zhi'shi'dan'gao
巧克力蛋卷	qiao'ke'li'dan'juan
巧克力蛋糕	qiao'ke'li'dan'gao
巧克力西瓜双色饼干	qiao'ke'li'xi'gua'shuang'se'bing'gan
巧克力鸡尾酒	qiao'ke'li'ji'wei'jiu
巧克力	qiao'ke'li
巧口	qiao'kou
巧酥	qiao'su
己二酸	ji'er'suan
己基肉桂醛	ji'ji'rou'gui'quan
己基间苯二酚	ji'ji'jian'ben'er'fen
己烯醇	ji'xi'chun
己烯醛	ji'xi'quan
己酸乙酯	ji'suan'yi'zhi
己酸烯丙酯	ji'suan'xi'bing'zhi
己酸香叶酯	ji'suan'xiang'ye'zhi
己酸	ji'suan
己醛	ji'quan
巴丹咖啡	ba'dan'ka'fei
巴伐利亚蛋糕	ba'fa'li'ya'dan'gao
巴国玉米糕	ba'guo'yu'mi'gao
巴山银芽	ba'shan'yin'ya
巴巴莱拉	ba'ba'lai'la
巴拉塔树胶	ba'la'ta'shu'jiao
巴旦杏	ba'dan'xing
巴西棕榈蜡	ba'xi'zong'lv'la
布丁蛋糕	bu'ding'dan'gao
布里芝士	bu'li'zhi'shi
师宗牛肉干	shi'zong'niu'rou'gan
希乐夫	xi'le'fu
希神咖啡	xi'shen'ka'fei
希腊罗马式咖啡	xi'la'luo'ma'shi'ka'fei
帕尔玛火腿	pa'er'ma'huo'tui
帕玛森芝士	pa'ma'sen'zhi'shi
帝亚吉欧	di'ya'ji'ou
带子上朝	dai'zi'shang'chao
带鱼罐头	dai'yu'guan'tou
常州大麻糕	chang'zhou'da'ma'gao
常德银片糕	chang'de'yin'pian'gao
干啤	gan'pi
干姜红茶	gan'jiang'hong'cha
干巴菌	gan'ba'jun
干梅子	gan'mei'zi
干火靠大虾	gan'huo'kao'da'xia
干炒牛河	gan'chao'niu'he
干炒牛肉丝	gan'chao'niu'rou'si
干炸丸子	gan'zha'wan'zi
干炸蟹枣	gan'zha'xie'zao
干炸赤鳞鱼	gan'zha'chi'lin'yu
干炸黄雀	gan'zha'huang'que
干烧冬笋	gan'shao'dong'sun
干烧大虾	gan'shao'da'xia
干烧明虾球	gan'shao'ming'xia'qiu
干烧牛筋	gan'shao'niu'jin
干烧牛肉片	gan'shao'niu'rou'pian
干烧荷包鱼	gan'shao'he'bao'yu
干烧萝卜	gan'shao'luo'bo
干烧辽参	gan'shao'liao'can
干烧鱼翅	gan'shao'yu'chi
干烧鱼	gan'shao'yu
干烧鸡翅	gan'shao'ji'chi
干烹仔鸡	gan'peng'zi'ji
干煎黄鱼	gan'jian'huang'yu
干煸冬笋	gan'bian'dong'sun
干煸四季豆	gan'bian'si'ji'dou
干煸牛肉丝	gan'bian'niu'rou'si
干煸牛腩	gan'bian'niu'nan
干煸神仙蟹	gan'bian'shen'xian'xie
干煸肉丝	gan'bian'rou'si
干煸苦瓜丝	gan'bian'ku'gua'si
干煸茭白	gan'bian'jiao'bai
干煸莲藕	gan'bian'lian'ou
干煸豇豆	gan'bian'jiang'dou
干煸香菇扁豆	gan'bian'xiang'gu'bian'dou
干煸鲜笋	gan'bian'xian'sun
干煸鳝背	gan'bian'shan'bei
干煸鳝鱼丝	gan'bian'shan'yu'si
干煸鳝鱼	gan'bian'shan'yu
干煸鸡丁	gan'bian'ji'ding
干煽牛肉丝	gan'shan'niu'rou'si
干白	gan'bai
干红	gan'hong
干菊花粥	gan'ju'hua'zhou
干菜擦酥饼	gan'cai'ca'su'bing
干菜焖肉	gan'cai'men'rou
干贝水晶鸡	gan'bei'shui'jing'ji
干贝汤	gan'bei'tang
干贝海棠果	gan'bei'hai'tang'guo
干贝萝卜汤	gan'bei'luo'bo'tang
干锅兔	gan'guo'tu
干锅带皮牛肉	gan'guo'dai'pi'niu'rou
干锅手撕包菜	gan'guo'shou'si'bao'cai
干锅腊味河蚌	gan'guo'la'wei'he'bang
干锅鸡翅	gan'guo'ji'chi
干风春鱼	gan'feng'chun'yu
平安茶	ping'an'cha
平水珠茶	ping'shui'zhu'cha
平湖糟蛋	ping'hu'zao'dan
平菇蛋汤	ping'gu'dan'tang
平菇	ping'gu
平锅羊肉	ping'guo'yang'rou
年轮蛋糕	nian'lun'dan'gao
广东月饼	guang'dong'yue'bing
广东桃酥	guang'dong'tao'su
广东省海南省	guang'dong'sheng'hai'nan'sheng
广东菜	guang'dong'cai
广东酥皮细点	guang'dong'su'pi'xi'dian
广东酥角	guang'dong'su'jiao
广佳豆豉鲮鱼	guang'jia'dou'chi'ling'yu
广味幼滑虾酱	guang'wei'you'hua'xia'jiang
广味排骨酱	guang'wei'pai'gu'jiang
广味海鲜酱	guang'wei'hai'xian'jiang
广味源一品鲜酱油	guang'wei'yuan'yi'pin'xian'jiang'you
广味源上等蚝油	guang'wei'yuan'shang'deng'hao'you
广味源五香粉	guang'wei'yuan'wu'xiang'fen
广味源冰花酸梅酱	guang'wei'yuan'bing'hua'suan'mei'jiang
广味源味极鲜酱油	guang'wei'yuan'wei'ji'xian'jiang'you
广味源大红浙醋	guang'wei'yuan'da'hong'zhe'cu
广味源度糯米白醋王	guang'wei'yuan'du'nuo'mi'bai'cu'wang
广味源排骨酱	guang'wei'yuan'pai'gu'jiang
广味源新老抽王	guang'wei'yuan'xin'lao'chou'wang
广味源新草菇老抽	guang'wei'yuan'xin'cao'gu'lao'chou
广味源柱侯酱	guang'wei'yuan'zhu'hou'jiang
广味源沙嗲酱	guang'wei'yuan'sha'dia'jiang
广味源沙姜粉	guang'wei'yuan'sha'jiang'fen
广味源沙茶酱	guang'wei'yuan'sha'cha'jiang
广味源海鲜酱	guang'wei'yuan'hai'xian'jiang
广味源生抽王	guang'wei'yuan'sheng'chou'wang
广味源白米醋	guang'wei'yuan'bai'mi'cu
广味源白酱油	guang'wei'yuan'bai'jiang'you
广味源盐炬鸡料	guang'wei'yuan'yan'ju'ji'liao
广味源胡椒粉	guang'wei'yuan'hu'jiao'fen
广味源蒸鱼豆豉油	guang'wei'yuan'zheng'yu'dou'chi'you
广味源金厨来排骨酱	guang'wei'yuan'jin'chu'lai'pai'gu'jiang
广味源金厨来海鲜酱	guang'wei'yuan'jin'chu'lai'hai'xian'jiang
广味源香麻油	guang'wei'yuan'xiang'ma'you
广味源鲍鱼汁	guang'wei'yuan'bao'yu'zhi
广味源鲜味老抽	guang'wei'yuan'xian'wei'lao'chou
广味蒜蓉辣椒酱	guang'wei'suan'rong'la'jiao'jiang
广味豆瓣酱	guang'wei'dou'ban'jiang
广安烘糕	guang'an'hong'gao
广州文昌鸡	guang'zhou'wen'chang'ji
广式五仁月饼	guang'shi'wu'ren'yue'bing
广式月饼	guang'shi'yue'bing
广式蜜饯	guang'shi'mi'jian
广式豆蓉月饼	guang'shi'dou'rong'yue'bing
广汉缠丝兔	guang'han'chan'si'tu
广灵五香瓜子	guang'ling'wu'xiang'gua'zi
广藿香油	guang'huo'xiang'you
广西壮族自治区	guang'xi'zhuang'zu'zi'zhi'qu
广达香辣红烧牛肉罐头	guang'da'xiang'la'hong'shao'niu'rou'guan'tou
庄园假日	zhuang'yuan'jia'ri
庆兰馅饼	qing'lan'xian'bing
庐山云雾茶	lu'shan'yun'wu'cha
库克洛夫	ku'ke'luo'fu
庚酸乙酯	geng'suan'yi'zhi
府陈年糟蛋	fu'chen'nian'zao'dan
庞德咖啡	pang'de'ka'fei
康加恋舞咖啡	kang'jia'lian'wu'ka'fei
康寿茶	kang'shou'cha
康师傅冰红茶	kang'shi'fu'bing'hong'cha
康师傅	kang'shi'fu
康桔桔圆果	kang'ju'ju'yuan'guo
廉州桂圆肉	lian'zhou'gui'yuan'rou
建德烧饼	jian'de'shao'bing
开口笑	kai'kou'xiao
开屏柴把桂鱼	kai'ping'chai'ba'gui'yu
开山白毫茶	kai'shan'bai'hao'cha
开平麻花	kai'ping'ma'hua
开心蔬麦	kai'xin'shu'mai
开水白菜	kai'shui'bai'cai
开胃水鱼	kai'wei'shui'yu
异国风情	yi'guo'feng'qing
异戊酸乙酯	yi'wu'suan'yi'zhi
异戊酸异戊酯	yi'wu'suan'yi'wu'zhi
异戊酸环己酯	yi'wu'suan'huan'ji'zhi
异抗坏血酸钠	yi'kang'huai'xue'suan'na
异抗坏血酸	yi'kang'huai'xue'suan
异构化乳糖液	yi'gou'hua'ru'tang'ye
异麦芽酮糖醇	yi'mai'ya'tong'tang'chun
异麦芽酮糖	yi'mai'ya'tong'tang
引子煎软饼	yin'zi'jian'ruan'bing
张恒春	zhang'heng'chun
张裕	zhang'yu
弥猴桃	mi'hou'tao
弹珠汽水	dan'zhu'qi'shui
强儿钙	qiang'er'gai
强化麦乳精	qiang'hua'mai'ru'jing
归参山药猪腰	gui'can'shan'yao'zhu'yao
当归枸杞面线	dang'gui'gou'qi'mian'xian
当归獐肉	dang'gui'zhang'rou
当归红枣汤冲剂	dang'gui'hong'zao'tang'chong'ji
当归鸡	dang'gui'ji
彝家花雕醉虾	yi'jia'hua'diao'zui'xia
彝家醉虾	yi'jia'zui'xia
彩丝金柳	cai'si'jin'liu
彩带鱼头	cai'dai'yu'tou
彩椒炒香肠	cai'jiao'chao'xiang'chang
彩色肉丝	cai'se'rou'si
彩蔬烩鸡油饭	cai'shu'hui'ji'you'fan
彩虹冰咖啡	cai'hong'bing'ka'fei
彩虹水晶球	cai'hong'shui'jing'qiu
往往清泉	wang'wang'qing'quan
径山茶	jing'shan'cha
徐州蜜三刀	xu'zhou'mi'san'dao
徐舍小酥糖	xu'she'xiao'su'tang
得奖英国老黑啤	de'jiang'ying'guo'lao'hei'pi
御泉杏仁露	yu'quan'xing'ren'lu
御珍	yu'zhen
御福坊	yu'fu'fang
御膳粥	yu'shan'zhou
御香源	yu'xiang'yuan
御龙火锅	yu'long'huo'guo
微晶纤维素	wei'jing'xian'wei'su
微晶鲜桔晶	wei'jing'xian'ju'jing
德国乳酪蛋糕	de'guo'ru'lao'dan'gao
德国啤酒	de'guo'pi'jiu
德州扒鸡	de'zhou'pa'ji
德式土豆泥	de'shi'tu'dou'ni
德式生汁香蕉卷	de'shi'sheng'zhi'xiang'jiao'juan
德懋恭水晶饼	de'mao'gong'shui'jing'bing
德泰麦芽糕	de'tai'mai'ya'gao
徽州园子	hui'zhou'yuan'zi
徽州圆子	hui'zhou'yuan'zi
徽州饼	hui'zhou'bing
徽式双冬	hui'shi'shuang'dong
徽菜	hui'cai
心太软巧克力蛋糕	xin'tai'ruan'qiao'ke'li'dan'gao
心形椰蓉面包	xin'xing'ye'rong'mian'bao
心形面包	xin'xing'mian'bao
心海蛋糕	xin'hai'dan'gao
心甜心桔片罐头	xin'tian'xin'ju'pian'guan'tou
必乐	bi'le
快乐搭档	kuai'le'da'dang
忻县瓦酥	xin'xian'wa'su
怀来杏脯	huai'lai'xing'fu
怀胎桂鱼	huai'tai'gui'yu
思乐冰	si'le'bing
思朗	si'lang
怡味莲	yi'wei'lian
怪味白肉	guai'wei'bai'rou
怪味胡豆	guai'wei'hu'dou
怪味鸡块	guai'wei'ji'kuai
怪味鸡片	guai'wei'ji'pian
怪味鸡	guai'wei'ji
总汇沙拉	zong'hui'sha'la
恋爱豆腐	lian'ai'dou'fu
恩尼艾斯	en'ni'ai'si
恩施玉露茶	en'shi'yu'lu'cha
恩济堂秋梨膏	en'ji'tang'qiu'li'gao
恭城柿饼	gong'cheng'shi'bing
悠泡水	you'pao'shui
情中情	qing'zhong'qing
情岛啤酒	qing'dao'pi'jiu
惠尔堂龟苓膏	hui'er'tang'gui'ling'gao
惠山油酥	hui'shan'you'su
惠美寿名茶	hui'mei'shou'ming'cha
意大利小松饼	yi'da'li'xiao'song'bing
意大利干椒	yi'da'li'gan'jiao
意大利调料	yi'da'li'tiao'liao
意大利贝蒂亚摩洛娜酒庄	yi'da'li'bei'di'ya'mo'luo'na'jiu'zhuang
意大利面	yi'da'li'mian
意式杏仁脆饼	yi'shi'xing'ren'cui'bing
慕尼黑啤酒	mu'ni'hei'pi'jiu
慕思蛋糕	mu'si'dan'gao
慕斯蛋糕	mu'si'dan'gao
慕斯	mu'si
慧娟火腿笋干老鸭面	hui'juan'huo'tui'sun'gan'lao'ya'mian
戊基肉桂醛	wu'ji'rou'gui'quan
成双成对	cheng'shuang'cheng'dui
成都子鸡	cheng'du'zi'ji
成都泡椒墨鱼仔	cheng'du'pao'jiao'mo'yu'zai
成都蛋汤	cheng'du'dan'tang
戚风蛋卷桂花糕	qi'feng'dan'juan'gui'hua'gao
戚风蛋糕	qi'feng'dan'gao
扁豆薏米炖鸡脚	bian'dou'yi'mi'dun'ji'jiao
手抓羊排	shou'zhua'yang'pai
手抓羊肉	shou'zhua'yang'rou
手撕干鱼仔	shou'si'gan'yu'zai
手撕牛肉	shou'si'niu'rou
手撕饼	shou'si'bing
手撕鸡	shou'si'ji
扒三样儿	ba'san'yang'er
扒三样	ba'san'yang
扒原壳鲍鱼	ba'yuan'ke'bao'yu
扒大肠油菜	ba'da'chang'you'cai
扒板	ba'ban
扒栗子	ba'li'zi
扒海参	ba'hai'shen
扒海羊	ba'hai'yang
扒牛肉条	ba'niu'rou'tiao
扒糕	pa'gao
扒肉	ba'rou
扒肘条	ba'zhou'tiao
扒酿海参	ba'niang'hai'shen
扒面筋	ba'mian'jin
扒鲍鱼芦笋	ba'bao'yu'lu'sun
扒鸡块儿	pa'ji'kuai'er
扒龙须鲍鱼	ba'long'xu'bao'yu
打发	da'fa
打老虎	da'lao'hu
托司卡蛋糕	tuo'si'ka'dan'gao
托盘	tuo'pan
扛糟羊肉	kang'zao'yang'rou
扛糟鸡	kang'zao'ji
扣肉梅菜	kou'rou'mei'cai
扣肉	kou'rou
扣鸡	kou'ji
扬州干丝	yang'zhou'gan'si
扯面	che'mian
扯麺	che'mian
扶风鹿糕	fu'feng'lu'gao
扶风鹿羔馍	fu'feng'lu'gao'mo
承德名胜蛋糕	cheng'de'ming'sheng'dan'gao
抓抓粉	zhua'zhua'fen
抓炒大虾	zhua'chao'da'xia
抓炒对虾	zhua'chao'dui'xia
抓炒里脊	zhua'chao'li'ji
抓炒鱼仁	zhua'chao'yu'ren
抓炒鱼片	zhua'chao'yu'pian
抓炒鲤鱼	zhua'chao'li'yu
抗坏血酸棕榈酸酯	kang'huai'xue'suan'zong'lv'suan'zhi
抗坏血酸磷酸酯镁	kang'huai'xue'suan'lin'suan'zhi'mei
抗坏血酸钙	kang'huai'xue'suan'gai
抗坏血酸钠	kang'huai'xue'suan'na
抗坏血酸	kang'huai'xue'suan
抗氧化剂	kang'yang'hua'ji
抗浪鱼	kang'lang'yu
抗结剂	kang'jie'ji
抗衰老啤酒	kang'shuai'lao'pi'jiu
折耳根炒肉丝	zhe'er'gen'chao'rou'si
折耳根炒腊肉	zhe'er'gen'chao'la'rou
抚仙湖抗浪鱼	fu'xian'hu'kang'lang'yu
抚州擦酥饼	fu'zhou'ca'su'bing
护色剂	hu'se'ji
抹茶冰淇淋蛋糕	mo'cha'bing'qi'lin'dan'gao
抹茶冰皮月饼	mo'cha'bing'pi'yue'bing
抹茶咖啡	mo'cha'ka'fei
抹茶慕斯	mo'cha'mu'si
抹茶椰奶凉糕	mo'cha'ye'nai'liang'gao
抹茶红豆戚风	mo'cha'hong'dou'qi'feng
抹茶蜂蜜蛋糕	mo'cha'feng'mi'dan'gao
抹茶轻乳酪蛋糕	mo'cha'qing'ru'lao'dan'gao
担担面	dan'dan'mian
拆冻鲫鱼	chai'dong'ji'yu
拆烩大鱼头	chai'hui'da'yu'tou
拆烩鲢鱼头	chai'hui'lian'yu'tou
拉糟鱼块	la'zao'yu'kuai
拉萨啤酒	la'sa'pi'jiu
拌海蜇	ban'hai'zhe
拌肚丝	ban'du'si
拌莴笋	ban'wo'sun
拌蟹肉	ban'xie'rou
拌豆腐干丝	ban'dou'fu'gan'si
拌银耳	ban'yin'er
拌鸡丝	ban'ji'si
拌鸡块	ban'ji'kuai
拌鸭掌	ban'ya'zhang
拌黄瓜	ban'huang'gua
拔丝什锦山药	ba'si'shi'jin'shan'yao
拔丝地瓜	ba'si'di'gua
拔丝小汤圆	ba'si'xiao'tang'yuan
拔丝山药	ba'si'shan'yao
拔丝桔子	ba'si'ju'zi
拔丝楂糕	ba'si'zha'gao
拔丝空心小枣	ba'si'kong'xin'xiao'zao
拔丝苹果	ba'si'ping'guo
拔丝蜜桔	ba'si'mi'ju
拔丝香蕉	ba'si'xiang'jiao
拿破仑奶油蛋糕	na'po'lun'nai'you'dan'gao
拿破伦酥	na'po'lun'su
拿铁咖啡	na'tie'ka'fei
挂炉烤鸭	gua'lu'kao'ya
挂霜丸子	gua'shuang'wan'zi
挞挞面	ta'ta'mian
挤花	ji'hua
振舟山	zhen'zhou'shan
换心乌贼	huan'xin'wu'zei
捶烩鸡片	chui'hui'ji'pian
捶鸡	chui'ji
掐菜炒鸡丝	qia'cai'chao'ji'si
排骨炖藕	pai'gu'dun'ou
接骨糯	jie'gu'nuo
提丝发糕	ti'si'fa'gao
提子白莲蓉软月饼	ti'zi'bai'lian'rong'ruan'yue'bing
提子黑糖糕	ti'zi'hei'tang'gao
提拉米苏芝士饼	ti'la'mi'su'zhi'shi'bing
提拉米苏	ti'la'mi'su
提浆月饼和五仁月饼	ti'jiang'yue'bing'he'wu'ren'yue'bing
提浆月饼	ti'jiang'yue'bing
搅团	jiao'tuan
摔饼	shuai'bing
摩利菌	mo'li'jun
摩卡冰咖啡	mo'ka'bing'ka'fei
摩卡薄荷咖啡	mo'ka'bo'he'ka'fei
摩卡蛋糕	mo'ka'dan'gao
摩根斯特	mo'gen'si'te
撒子麻花	sa'zi'ma'hua
支竹羊腩煲	zhi'zhu'yang'nan'bao
攸县香干	you'xian'xiang'gan
改性大豆磷脂	gai'xing'da'dou'lin'zhi
政大白牡丹茶	zheng'da'bai'mu'dan'cha
敬亭绿雪茶	jing'ting'lv'xue'cha
整肢龙虾	zheng'zhi'long'xia
整鱼两吃	zheng'yu'liang'chi
文君茶	wen'jun'cha
文山鸡丁	wen'shan'ji'ding
文旦	wen'dan
文昌按粑	wen'chang'an'ba
文昌空心煎堆	wen'chang'kong'xin'jian'dui
文昌鸡	wen'chang'ji
斋鸭掌草菇煲	zhai'ya'zhang'cao'gu'bao
斑鱼汤	ban'yu'tang
斗糕	dou'gao
斩鱼圆	zhan'yu'yuan
斯坦利	si'tan'li
新一代长城	xin'yi'dai'chang'cheng
新东阳月饼	xin'dong'yang'yue'bing
新东阳素食面筋	xin'dong'yang'su'shi'mian'jin
新丰小吃	xin'feng'xiao'chi
新兴牛肉丸	xin'xing'niu'rou'wan
新奇爆米花	xin'qi'bao'mi'hua
新奥尔良腌制料	xin'ao'er'liang'yan'zhi'liao
新派脆薄饼	xin'pai'cui'bao'bing
新红铝色淀	xin'hong'lv'se'dian
新红	xin'hong
新都桂花糕	xin'du'gui'hua'gao
新长发糖炒栗子	xin'chang'fa'tang'chao'li'zi
新鲜木瓜南北杏炖雪耳	xin'xian'mu'gua'nan'bei'xing'dun'xue'er
方便米粉	fang'bian'mi'fen
方便粥	fang'bian'zhou
方便面	fang'bian'mian
方糖	fang'tang
方腊鱼	fang'la'yu
方鱼蒸鸡	fang'yu'zheng'ji
旅游便宴罐头	lv'you'bian'yan'guan'tou
旅游罐头	lv'you'guan'tou
旅行家	lv'xing'jia
无为熏鸭	wu'wei'xun'ya
无核小葡萄	wu'he'xiao'pu'tao
无核桔	wu'he'ju
无核糖枣	wu'he'tang'zao
无糖豆渣纤维饮料	wu'tang'dou'zha'xian'wei'yin'liao
无花果炖瘦肉	wu'hua'guo'dun'shou'rou
无花果炖肉	wu'hua'guo'dun'rou
无花果	wu'hua'guo
无钖毫茶	wu'yang'hao'cha
无锡嫩子排	wu'xi'nen'zi'pai
无锡肉排	wu'xi'rou'pai
日式戚风	ri'shi'qi'feng
日月生辉	ri'yue'sheng'hui
日本酱油	ri'ben'jiang'you
日落黄铝色淀	ri'luo'huang'lv'se'dian
日落黄	ri'luo'huang
早白尖	zao'bai'jian
早餐肠	zao'can'chang
早餐蛋卷饼	zao'can'dan'juan'bing
早餐饼	zao'can'bing
旭日升	xu'ri'sheng
旺得芬	wang'de'fen
旺运红	wang'yun'hong
昆布海澡瘦肉汤	kun'bu'hai'zao'shou'rou'tang
昆特香精	kun'te'xiang'jing
昌化山核桃	chang'hua'shan'he'tao
昌化鸡血石	chang'hua'ji'xue'shi
昌顺干货	chang'shun'gan'huo
明心糖	ming'xin'tang
明炉梅子鸭	ming'lu'mei'zi'ya
明珠豆腐	ming'zhu'dou'fu
明珠香芋饼	ming'zhu'xiang'yu'bing
明矾	ming'fan
明胶	ming'jiao
明良生煎包	ming'liang'sheng'jian'bao
明虾金鱼酥	ming'xia'jin'yu'su
星冰乐	xing'bing'le
星巴克月饼	xing'ba'ke'yue'bing
星巴克的纽约芝士	xing'ba'ke'de'niu'yue'zhi'shi
春卷	chun'juan
春笋炒步鱼	chun'sun'chao'bu'yu
春笋白拌鸡	chun'sun'bai'ban'ji
春笋豌豆	chun'sun'wan'dou
春蕊	chun'rui
春蚕吐丝	chun'can'tu'si
春风减肥茶	chun'feng'jian'fei'cha
春饼	chun'bing
晒青毛茶	shai'qing'mao'cha
普斯福特	pu'si'fu'te
普洱茶糕点	pu'er'cha'gao'dian
普洱茶	pu'er'cha
普者黑清汤鱼	pu'zhe'hei'qing'tang'yu
普者黑银鱼	pu'zhe'hei'yin'yu
普者黑黑鱼	pu'zhe'hei'hei'yu
普陀山佛茶	pu'tuo'shan'fo'cha
普鲁兰酶	pu'lu'lan'mei
普鲁红糖	pu'lu'hong'tang
景星碧绿茶	jing'xing'bi'lv'cha
晶玉海棠	jing'yu'hai'tang
智德	zhi'de
晾肉	liang'rou
曲奇饼干	qu'qi'bing'gan
曲酒	qu'jiu
曲靖韭菜花	qu'jing'jiu'cai'hua
曼可顿红豆面包	man'ke'dun'hong'dou'mian'bao
曼顿	man'dun
月宫饼	yue'gong'bing
月桂叶	yue'gui'ye
月桂酸	yue'gui'suan
朗姆酒黑加仑乳酪	lang'mu'jiu'hei'jia'lun'ru'lao
朗姆酒	lang'mu'jiu
望海天天渔港	wang'hai'tian'tian'yu'gang
朝包子	chao'bao'zi
朝天锅	chao'tian'guo
朝阳鸡蛋豆腐	zhao'yang'ji'dan'dou'fu
朝鲜蓟亚之竹心蔬菜罐头	chao'xian'ji'ya'zhi'zhu'xin'shu'cai'guan'tou
木三对	mu'san'dui
木材蛋糕	mu'cai'dan'gao
木桶辣子虾	mu'tong'la'zi'xia
木洞晒枣	mu'dong'shai'zao
木瓜墨鱼汤	mu'gua'mo'yu'tang
木瓜煲老鸭	mu'gua'bao'lao'ya
木瓜牛乳	mu'gua'niu'ru
木瓜牛奶	mu'gua'niu'nai
木瓜生鱼汤	mu'gua'sheng'yu'tang
木瓜粟米花生生鱼汤	mu'gua'su'mi'hua'sheng'sheng'yu'tang
木瓜蛋白酶	mu'gua'dan'bai'mei
木瓜辽参	mu'gua'liao'can
木瓜酥	mu'gua'su
木糖醇酐单硬脂酸酯	mu'tang'chun'gan'dan'ying'zhi'suan'zhi
木糖醇	mu'tang'chun
木素	mu'su
木耳炒肉片	mu'er'chao'rou'pian
木耳红枣粥	mu'er'hong'zao'zhou
木耳绿豆粥	mu'er'lv'dou'zhou
木耳酱	mu'er'jiang
木耳顺风	mu'er'shun'feng
木耳黄瓜	mu'er'huang'gua
木轮围边戚风卷	mu'lun'wei'bian'qi'feng'juan
朱古力忌林蛋糕	zhu'gu'li'ji'lin'dan'gao
朵颐辣子鸡	duo'yi'la'zi'ji
杀猪饭	sha'zhu'fan
杂烩锅子	za'hui'guo'zi
杂粮核桃面包	za'liang'he'tao'mian'bao
杂糖	za'tang
杂豆小麦粥	za'dou'xiao'mai'zhou
李杏	li'xing
李派林急汁	li'pai'lin'ji'zhi
李锦记卤水汁	li'jin'ji'lu'shui'zhi
李锦记叉烧酱	li'jin'ji'cha'shao'jiang
李锦记幼滑虾酱	li'jin'ji'you'hua'xia'jiang
李锦记排骨酱	li'jin'ji'pai'gu'jiang
李锦记旧装蚝油	li'jin'ji'jiu'zhuang'hao'you
李锦记柱侯酱	li'jin'ji'zhu'hou'jiang
李锦记桂林辣椒酱	li'jin'ji'gui'lin'la'jiao'jiang
李锦记沙茶酱	li'jin'ji'sha'cha'jiang
李锦记海鲜酱	li'jin'ji'hai'xian'jiang
李锦记精选生抽	li'jin'ji'jing'xuan'sheng'chou
李锦记精选老抽	li'jin'ji'jing'xuan'lao'chou
李锦记草菇老抽	li'jin'ji'cao'gu'lao'chou
李锦记蒸鱼豆豉	li'jin'ji'zheng'yu'dou'chi
李锦记蒸鱼豉油	li'jin'ji'zheng'yu'chi'you
李锦记豆瓣酱	li'jin'ji'dou'ban'jiang
李锦记豉油鸡汁	li'jin'ji'chi'you'ji'zhi
李锦记财神蚝油	li'jin'ji'cai'shen'hao'you
李锦记金标生抽	li'jin'ji'jin'biao'sheng'chou
李鸿章杂烩	li'hong'zhang'za'hui
杏仁塔	xing'ren'ta
杏仁小饼干	xing'ren'xiao'bing'gan
杏仁橄榄	xing'ren'gan'lan
杏仁水果大蛋糕	xing'ren'shui'guo'da'dan'gao
杏仁沙拉	xing'ren'sha'la
杏仁海绵蛋糕	xing'ren'hai'mian'dan'gao
杏仁炖肉	xing'ren'dun'rou
杏仁草莓奶昔	xing'ren'cao'mei'nai'xi
杏仁薄脆	xing'ren'bao'cui
杏仁蛋糕	xing'ren'dan'gao
杏仁豆腐	xing'ren'dou'fu
杏仁银肺汤	xing'ren'yin'fei'tang
杏仁饼	xing'ren'bing
杏仁香片酥	xing'ren'xiang'pian'su
杏仁鱼鳃	xing'ren'yu'sai
杏圆饼干	xing'yuan'bing'gan
杏子甜果汁	xing'zi'tian'guo'zhi
杏子	xing'zi
杏核	xing'he
杏汁	xing'zhi
杏源	xing'yuan
杏肉	xing'rou
杏花村	xing'hua'cun
杏花楼广式月饼	xing'hua'lou'guang'shi'yue'bing
杏香冻芝士	xing'xiang'dong'zhi'shi
杜仲山楂猪肚汤	du'zhong'shan'zha'zhu'du'tang
杜仲排骨炖	du'zhong'pai'gu'dun
杜仲腰花	du'zhong'yao'hua
杜任酥糖	du'ren'su'tang
杜康牌	du'kang'pai
杜康	du'kang
杜本内	du'ben'nei
杜梅酥	du'mei'su
杞子南枣煲鸡蛋	qi'zi'nan'zao'bao'ji'dan
杞子炖羊脑	qi'zi'dun'yang'nao
杞子牛肝汤	qi'zi'niu'gan'tang
杞忧烘皮肘	qi'you'hong'pi'zhou
杞精炖鹌鹑	qi'jing'dun'an'chun
杨村糕干	yang'cun'gao'gan
杨梅甜果汁	yang'mei'tian'guo'zhi
杨梅糕	yang'mei'gao
杨梅罐头	yang'mei'guan'tou
杨梅虾球	yang'mei'xia'qiu
杨梅醛	yang'mei'quan
杭三鲜	hang'san'xian
杭州刺绣	hang'zhou'ci'xiu
杭州绿豆糕	hang'zhou'lv'dou'gao
杭州菜	hang'zhou'cai
杭州龙井	hang'zhou'long'jing
杭式榴莲酥	hang'shi'liu'lian'su
松仁粉丝	song'ren'fen'si
松子仁米粥	song'zi'ren'mi'zhou
松子枣泥拉糕	song'zi'zao'ni'la'gao
松子河虾仁	song'zi'he'xia'ren
松子茄鱼	song'zi'qie'yu
松子酥	song'zi'su
松子鱼米	song'zi'yu'mi
松子麻饼	song'zi'ma'bing
松峰绿茶	song'feng'lv'cha
松树猴头	song'shu'hou'tou
松油醇	song'you'chun
松糕	song'gao
松肉	song'rou
松脆海蜇皮	song'cui'hai'zhe'pi
松花淡菜粥	song'hua'dan'cai'zhou
松花饼干	song'hua'bing'gan
松花	song'hua
松茸	song'rong
松露巧克力	song'lu'qiao'ke'li
松露菌	song'lu'jun
松风	song'feng
松香季戊四醇酯	song'xiang'ji'wu'si'chun'zhi
松香甘油酯	song'xiang'gan'you'zhi
松鹤延年	song'he'yan'nian
松鼠桂鱼	song'shu'gui'yu
松鼠鳃鱼	song'shu'sai'yu
松鼠鳜鱼	song'shu'gui'yu
板兰根粥	ban'lan'gen'zhou
板栗仔鸡	ban'li'zi'ji
板栗月饼	ban'li'yue'bing
板栗焖仔鸡	ban'li'men'zi'ji
板栗煲老鸡	ban'li'bao'lao'ji
板栗红烧肉	ban'li'hong'shao'rou
板栗酒	ban'li'jiu
板鸭	ban'ya
枇杷叶苡仁粥	pi'pa'ye'yi'ren'zhou
果仁夹心蛋糕	guo'ren'jia'xin'dan'gao
果仁排骨	guo'ren'pai'gu
果佳	guo'jia
果冻布丁	guo'dong'bu'ding
果后	guo'hou
果料糖蜂糕	guo'liao'tang'feng'gao
果汁伴侣	guo'zhi'ban'lv
果汁煎肉脯	guo'zhi'jian'rou'pu
果汁煎鸡肉	guo'zhi'jian'ji'rou
果汁肉脯	guo'zhi'rou'pu
果汁鱼块	guo'zhi'yu'kuai
果汁鸡条	guo'zhi'ji'tiao
果汁鹌鹑	guo'zhi'an'chun
果粒悬浮饮料	guo'li'xuan'fu'yin'liao
果粒茶	guo'li'cha
果糖饮料	guo'tang'yin'liao
果肉	guo'rou
果胶裂解酶	guo'jiao'lie'jie'mei
果胶酯酶	guo'jiao'zhi'mei
果胶酶制剂	guo'jiao'mei'zhi'ji
果胶	guo'jiao
果蔬汁	guo'shu'zhi
果蔬药酒	guo'shu'yao'jiu
果酱三明治	guo'jiang'san'ming'zhi
果酱千层派	guo'jiang'qian'ceng'pai
果酱夹心饼乾	guo'jiang'jia'xin'bing'qian
果酱夹心饼	guo'jiang'jia'xin'bing
果酱巧克力	guo'jiang'qiao'ke'li
果酱瑞士卷	guo'jiang'rui'shi'juan
果酱蛋糕卷	guo'jiang'dan'gao'juan
果酱酥	guo'jiang'su
果香慕斯蛋糕	guo'xiang'mu'si'dan'gao
枣之礼	zao'zhi'li
枣仁龙眼粥	zao'ren'long'yan'zhou
枣方肉	zao'fang'rou
枣泥山药糕	zao'ni'shan'yao'gao
枣泥拉糕	zao'ni'la'gao
枣泥松糕	zao'ni'song'gao
枣泥桃酥	zao'ni'tao'su
枣泥米糕	zao'ni'mi'gao
枣泥糕	zao'ni'gao
枣泥蛋糕	zao'ni'dan'gao
枣泥酥	zao'ni'su
枸杞和发菜烤麸罐头	gou'qi'he'fa'cai'kao'fu'guan'tou
枸杞山药粥	gou'qi'shan'yao'zhou
枸杞海参鸽蛋	gou'qi'hai'shen'ge'dan
枸杞炖羊脑	gou'qi'dun'yang'nao
枸杞牛肝汤	gou'qi'niu'gan'tang
枸杞牛鞭汤	gou'qi'niu'bian'tang
枸杞田螺汤	gou'qi'tian'luo'tang
枸杞粥	gou'qi'zhou
枸杞红枣乌鸡汤	gou'qi'hong'zao'wu'ji'tang
枸杞羊肝羹	gou'qi'yang'gan'geng
枸杞茶	gou'qi'cha
枸杞莲子鸡汤	gou'qi'lian'zi'ji'tang
枸杞莲心鸡汤	gou'qi'lian'xin'ji'tang
枸杞菊花煲排骨	gou'qi'ju'hua'bao'pai'gu
柏龙	bai'long
柑桔嚢胞罐头	gan'ju'nang'bao'guan'tou
柑桔类果汁饮料	gan'ju'lei'guo'zhi'yin'liao
柑桔黄	gan'ju'huang
柑桔	gan'ju
柑橘黄	gan'ju'huang
柚子蜂蜜	you'zi'feng'mi
柚子蜜	you'zi'mi
柚皮蒸排骨	you'pi'zheng'pai'gu
柠檬乳酪饼	ning'meng'ru'lao'bing
柠檬夹心蛋糕	ning'meng'jia'xin'dan'gao
柠檬小蛋糕	ning'meng'xiao'dan'gao
柠檬摩司蛋糕	ning'meng'mo'si'dan'gao
柠檬杏仁小蛋糕	ning'meng'xing'ren'xiao'dan'gao
柠檬汁	ning'meng'zhi
柠檬油	ning'meng'you
柠檬茶冻	ning'meng'cha'dong
柠檬薏米水	ning'meng'yi'mi'shui
柠檬蛋糕	ning'meng'dan'gao
柠檬酸一钠	ning'meng'suan'yi'na
柠檬酸亚锡二钠	ning'meng'suan'ya'xi'er'na
柠檬酸钙	ning'meng'suan'gai
柠檬酸钠	ning'meng'suan'na
柠檬酸钾	ning'meng'suan'jia
柠檬酸铁铵	ning'meng'suan'tie'an
柠檬酸铁	ning'meng'suan'tie
柠檬酸	ning'meng'suan
柠檬鸡	ning'meng'ji
柠檬黄铝色淀	ning'meng'huang'lv'se'dian
柠檬黄	ning'meng'huang
柠汁炸软鸡	ning'zhi'zha'ruan'ji
柠汁焗鹌鹑	ning'zhi'ju'an'chun
柠酸酸钾	ning'suan'suan'jia
柱侯酱凤爪	zhu'hou'jiang'feng'zhao
柳城云片糕	liu'cheng'yun'pian'gao
柴把鱼	chai'ba'yu
柿叶茶	shi'ye'cha
柿子包	shi'zi'bao
柿椒炒嫩玉米	shi'jiao'chao'nen'yu'mi
栀子蓝	zhi'zi'lan
栀子黄	zhi'zi'huang
树根蛋糕	shu'gen'dan'gao
树花炖土鸡	shu'hua'dun'tu'ji
栗子淮山猪蹄汤	li'zi'huai'shan'zhu'ti'tang
栗子炒子鸡	li'zi'chao'zi'ji
栗子焖羊肉	li'zi'men'yang'rou
栗子煲鸡脚	li'zi'bao'ji'jiao
栗子球	li'zi'qiu
栗子白菜	li'zi'bai'cai
栗子糕	li'zi'gao
栗子肉	li'zi'rou
栗子莲子猪腰汤	li'zi'lian'zi'zhu'yao'tang
栗子蒙布朗芝士蛋糕	li'zi'meng'bu'lang'zhi'shi'dan'gao
栗子蛋糕	li'zi'dan'gao
栗子鸡	li'zi'ji
栗子黄焖鸡	li'zi'huang'men'ji
栗羊羹	li'yang'geng
核桃仁小蛋糕	he'tao'ren'xiao'dan'gao
核桃仁	he'tao'ren
核桃冻	he'tao'dong
核桃夹心糕	he'tao'jia'xin'gao
核桃奶	he'tao'nai
核桃松糕	he'tao'song'gao
核桃糕和花生糕	he'tao'gao'he'hua'sheng'gao
核桃糕	he'tao'gao
核桃红米饭	he'tao'hong'mi'fan
核桃葡萄干面包	he'tao'pu'tao'gan'mian'bao
核桃豆沙味月饼	he'tao'dou'sha'wei'yue'bing
核桃酥	he'tao'su
核桃露丸子	he'tao'lu'wan'zi
核桃香脆	he'tao'xiang'cui
核桃鸡汤	he'tao'ji'tang
核黄素	he'huang'su
格林斯通	ge'lin'si'tong
格瓦斯饮料	ge'wa'si'yin'liao
桂发祥麻花	gui'fa'xiang'ma'hua
桂圆羊肉煲	gui'yuan'yang'rou'bao
桂圆蛋花茶罐头	gui'yuan'dan'hua'cha'guan'tou
桂平西山茶	gui'ping'xi'shan'cha
桂林米粉	gui'lin'mi'fen
桂林酥糖	gui'lin'su'tang
桂花元宵	gui'hua'yuan'xiao
桂花干贝	gui'hua'gan'bei
桂花方酥	gui'hua'fang'su
桂花果粉	gui'hua'guo'fen
桂花栗饼	gui'hua'li'bing
桂花核桃冻	gui'hua'he'tao'dong
桂花楂糕	gui'hua'zha'gao
桂花海蜇	gui'hua'hai'zhe
桂花浸膏	gui'hua'jin'gao
桂花白糖饼	gui'hua'bai'tang'bing
桂花糖大栗	gui'hua'tang'da'li
桂花糖年糕	gui'hua'tang'nian'gao
桂花糯米藕	gui'hua'nuo'mi'ou
桂花红烧肉	gui'hua'hong'shao'rou
桂花翅子	gui'hua'chi'zi
桂花肉	gui'hua'rou
桂花茶饼	gui'hua'cha'bing
桂花莲藕	gui'hua'lian'ou
桂花酥糖	gui'hua'su'tang
桂花雀蛋	gui'hua'que'dan
桂花香蕉	gui'hua'xiang'jiao
桂花鱼条	gui'hua'yu'tiao
桂醛	gui'quan
桂鱼排骨	gui'yu'pai'gu
桃仁鸡丁	tao'ren'ji'ding
桃仁鸭方	tao'ren'ya'fang
桃子色拉	tao'zi'se'la
桃杞鸡卷	tao'qi'ji'juan
桃片糕	tao'pian'gao
桃花鸡腿	tao'hua'ji'tui
桃酥鸡糕	tao'su'ji'gao
桃酥	tao'su
桃醛	tao'quan
桃金娘	tao'jin'niang
桃麻猪油糕	tao'ma'zhu'you'gao
桉叶油	an'ye'you
桉叶糖	an'ye'tang
桉叶素	an'ye'su
桐庐白梨	tong'lu'bai'li
桐蛋	tong'dan
桑叶冻糕	sang'ye'dong'gao
桑叶眉豆卷	sang'ye'mei'dou'juan
桑寄生茶	sang'ji'sheng'cha
桑普莉	sang'pu'li
桑杏炖猪肺	sang'xing'dun'zhu'fei
桑椹红枣汤	sang'shen'hong'zao'tang
桑椹红	sang'shen'hong
桑椹菊花茶	sang'shen'ju'hua'cha
桑芽茶	sang'ya'cha
桑葚粥	sang'shen'zhou
桑葚芝麻粥	sang'shen'zhi'ma'zhou
桔子柠檬布丁	ju'zi'ning'meng'bu'ding
桔瓣广昌莲	ju'ban'guang'chang'lian
桔瓣鱼汆	ju'ban'yu'cuan
桔皮酱夹心饼干	ju'pi'jiang'jia'xin'bing'gan
桔络丸子	ju'luo'wan'zi
桔花晶	ju'hua'jing
桔阳	ju'yang
梁平甜茶	liang'ping'tian'cha
梁渡银针	liang'du'yin'zhen
梅兰锡咖啡	mei'lan'xi'ka'fei
梅子排骨	mei'zi'pai'gu
梅子肉	mei'zi'rou
梅干菜烧肉	mei'gan'cai'shao'rou
梅林里脊	mei'lin'li'ji
梅竹山石	mei'zhu'shan'shi
梅花粥	mei'hua'zhou
梅花蛋糕	mei'hua'dan'gao
梅花香芋	mei'hua'xiang'yu
梅菜扣肉	mei'cai'kou'rou
梓潼片粉	zi'tong'pian'fen
梓潼酥饼	zi'tong'su'bing
梧州月饼	wu'zhou'yue'bing
梧州蜜枣	wu'zhou'mi'zao
梭子蟹	suo'zi'xie
梳乎厘	shu'hu'li
梳子百页	shu'zi'bai'ye
棉花糕	mian'hua'gao
棉花糖和桔片冻糖	mian'hua'tang'he'ju'pian'dong'tang
棉花糖	mian'hua'tang
棋仙峰	qi'xian'feng
棋子烧饼	qi'zi'shao'bing
棋盘曲奇饼	qi'pan'qu'qi'bing
棍棍麺	gun'gun'mian
棒棒肉	bang'bang'rou
棒棒鸡丝	bang'bang'ji'si
棒棒鸡	bang'bang'ji
棕榈酸	zong'lv'suan
棕香羊排	zong'xiang'yang'pai
森参	sen'can
森林木盒	sen'lin'mu'he
植物炭黑	zhi'wu'tan'hei
植物甲萘醒	zhi'wu'jia'nai'xing
植物饮料	zhi'wu'yin'liao
植酸钠	zhi'suan'na
植酸	zhi'suan
椒油扁豆	jiao'you'bian'dou
椒油炝芹菜	jiao'you'qiang'qin'cai
椒盐八宝鸡	jiao'yan'ba'bao'ji
椒盐桃片	jiao'yan'tao'pian
椒盐肘子	jiao'yan'zhou'zi
椒盐肚尖	jiao'yan'du'jian
椒盐虾	jiao'yan'xia
椒盐蹄膀	jiao'yan'ti'bang
椒盐麻饼	jiao'yan'ma'bing
椒盐	jiao'yan
椒麻豆腐鸡	jiao'ma'dou'fu'ji
椒麻鸡片	jiao'ma'ji'pian
椒麻鸡	jiao'ma'ji
椰奶	ye'nai
椰子汁	ye'zi'zhi
椰子糕	ye'zi'gao
椰子酱和椰子糖	ye'zi'jiang'he'ye'zi'tang
椰子饼	ye'zi'bing
椰子马铃薯牛肉汤	ye'zi'ma'ling'shu'niu'rou'tang
椰枣	ye'zao
椰树	ye'shu
椰汁板兰糕	ye'zhi'ban'lan'gao
椰汁板子糕	ye'zhi'ban'zi'gao
椰汁红豆糕	ye'zhi'hong'dou'gao
椰蓉包	ye'rong'bao
椰蓉小饼干	ye'rong'xiao'bing'gan
椰蓉挞	ye'rong'ta
椰蓉杏仁饼	ye'rong'xing'ren'bing
椰蓉面包	ye'rong'mian'bao
椰蓉	ye'rong
椰酥条	ye'su'tiao
椰酱	ye'jiang
椰香咖喱鸡	ye'xiang'ga'li'ji
椰香红豆糕	ye'xiang'hong'dou'gao
椰香花卷	ye'xiang'hua'juan
椰香面包	ye'xiang'mian'bao
椿芽焖蛋	chun'ya'men'dan
榄仁切蛋糕	lan'ren'qie'dan'gao
榄仁猪油糕	lan'ren'zhu'you'gao
榆林豆腐	yu'lin'dou'fu
榕树茶	rong'shu'cha
榨菜蒸大鳝	zha'cai'zheng'da'shan
榴莲椰奶蛋糕	liu'lian'ye'nai'dan'gao
榴莲酥	liu'lian'su
槐花木耳猪肚汤	huai'hua'mu'er'zhu'du'tang
槐花猪肠汤	huai'hua'zhu'chang'tang
槐豆胶	huai'dou'jiao
槟榔子	bing'lang'zi
槭风蛋糕	qi'feng'dan'gao
槽子糕	cao'zi'gao
樟脑	zhang'nao
樟茶鸡	zhang'cha'ji
樟茶鸭子	zhang'cha'ya'zi
樟茶鸭	zhang'cha'ya
横丝酥饼	heng'si'su'bing
樱桃土豆	ying'tao'tu'dou
樱桃巧克力蛋糕	ying'tao'qiao'ke'li'dan'gao
樱桃派	ying'tao'pai
樱桃肉	ying'tao'rou
樱桃车里子	ying'tao'che'li'zi
樱桃酒咖啡	ying'tao'jiu'ka'fei
樽皇酒具	zun'huang'jiu'ju
橄榄油	gan'lan'you
橄榄炖鸡	gan'lan'dun'ji
橄榄菜茄丁面	gan'lan'cai'qie'ding'mian
橘红糕	ju'hong'gao
橘露汤圆	ju'lu'tang'yuan
橘香白巧克力	ju'xiang'bai'qiao'ke'li
橙味核桃蛋糕	cheng'wei'he'tao'dan'gao
橙汁	cheng'zhi
橙花排骨	cheng'hua'pai'gu
橙酒汁	cheng'jiu'zhi
橡子壳棕	xiang'zi'ke'zong
欢心美	huan'xin'mei
欧利伐	ou'li'fa
欧培拉	ou'pei'la
欧式蛋糕	ou'shi'dan'gao
欧式重乳酪蛋糕	ou'shi'zhong'ru'lao'dan'gao
欧斯麦蛋卷礼盒	ou'si'mai'dan'juan'li'he
欧查果	ou'cha'guo
欧蕾冰咖啡	ou'lei'bing'ka'fei
正咖喱油	zheng'ga'li'you
正咖喱粉	zheng'ga'li'fen
正山小种红茶	zheng'shan'xiao'zhong'hong'cha
正明斋糕点	zheng'ming'zhai'gao'dian
武则天茶食	wu'ze'tian'cha'shi
武夷山岩茶	wu'yi'shan'yan'cha
武汉热干面	wu'han're'gan'mian
武汉软糖	wu'han'ruan'tang
武穴酥糖	wu'xue'su'tang
毋米粥	wu'mi'zhou
母子相会	mu'zi'xiang'hui
比利时啤酒	bi'li'shi'pi'jiu
比目鱼	bi'mu'yu
比萨	bi'sa
毛叔	mao'shu
毛哥老鸭汤	mao'ge'lao'ya'tang
毛峰熏鲥鱼	mao'feng'xun'shi'yu
毛桃	mao'tao
毛毛虫面包	mao'mao'chong'mian'bao
毛毛面	mao'mao'mian
毛肚火锅	mao'du'huo'guo
毛血旺	mao'xue'wang
毛豆煎臭豆腐	mao'dou'jian'chou'dou'fu
毡酒	zhan'jiu
气磺蛋	qi'huang'dan
氢化松香甘油酯	qing'hua'song'xiang'gan'you'zhi
氢氧化钙	qing'yang'hua'gai
氢氧化钠	qing'yang'hua'na
氢氧化钾	qing'yang'hua'jia
氧化硬脂精	yang'hua'ying'zhi'jing
氧化铁红	yang'hua'tie'hong
氧化铁黑	yang'hua'tie'hei
氧化镁	yang'hua'mei
氨基乙酸	an'ji'yi'suan
氯化胆碱	lv'hua'dan'jian
氯化钙	lv'hua'gai
氯化钾	lv'hua'jia
氯化锰	lv'hua'meng
氯化镁	lv'hua'mei
氰钴胺素	qing'gu'an'su
水产罐头	shui'chan'guan'tou
水八块	shui'ba'kuai
水分保持剂	shui'fen'bao'chi'ji
水发海参	shui'fa'hai'shen
水晶南瓜包	shui'jing'nan'gua'bao
水晶南瓜	shui'jing'nan'gua
水晶扣肉	shui'jing'kou'rou
水晶明虾球	shui'jing'ming'xia'qiu
水晶楂糕	shui'jing'zha'gao
水晶橘子	shui'jing'ju'zi
水晶猪皮冻	shui'jing'zhu'pi'dong
水晶粉	shui'jing'fen
水晶翡翠饺	shui'jing'fei'cui'jiao
水晶肘子	shui'jing'zhou'zi
水晶肴肉	shui'jing'yao'rou
水晶蟹粉卷	shui'jing'xie'fen'juan
水晶蹄膀香肴肉	shui'jing'ti'bang'xiang'yao'rou
水晶软糖	shui'jing'ruan'tang
水晶酥	shui'jing'su
水晶饼	shui'jing'bing
水杨酸甲酯	shui'yang'suan'jia'zhi
水果塔	shui'guo'ta
水果夹心蛋糕	shui'guo'jia'xin'dan'gao
水果奶油蛋糕	shui'guo'nai'you'dan'gao
水果板栗罐头	shui'guo'ban'li'guan'tou
水果派	shui'guo'pai
水果煎饼卷	shui'guo'jian'bing'juan
水果花篮泡芙	shui'guo'hua'lan'pao'fu
水果蛋糕	shui'guo'dan'gao
水果鸡	shui'guo'ji
水泡饼干	shui'pao'bing'gan
水浒肉	shui'hu'rou
水煎包	shui'jian'bao
水煮冬笋罐头	shui'zhu'dong'sun'guan'tou
水煮凤片	shui'zhu'feng'pian
水煮回头鱼	shui'zhu'hui'tou'yu
水煮春笋罐头	shui'zhu'chun'sun'guan'tou
水煮牛肉	shui'zhu'niu'rou
水煮猪杂	shui'zhu'zhu'za
水煮白扎肉	shui'zhu'bai'zha'rou
水煮笋罐头	shui'zhu'sun'guan'tou
水煮羊肉	shui'zhu'yang'rou
水煮肉片	shui'zhu'rou'pian
水煮蹄花	shui'zhu'ti'hua
水煮鱼	shui'zhu'yu
水煮鲢鱼	shui'zhu'lian'yu
水瓜柳	shui'gua'liu
水盆羊肉	shui'pen'yang'rou
水管面	shui'guan'mian
水花糖糕	shui'hua'tang'gao
水蜜桃	shui'mi'tao
水饺豆沙煎饼	shui'jiao'dou'sha'jian'bing
永恒的提拉米苏	yong'heng'de'ti'la'mi'su
氽三样儿	tun'san'yang'er
氽丸子	tun'wan'zi
氽发菜三丝	tun'fa'cai'san'si
氽脊脑	tun'ji'nao
氽虾蘑海	tun'xia'mo'hai
氽银耳鸭舌	tun'yin'er'ya'she
汇堡干红	hui'bao'gan'hong
汉中梆梆面	han'zhong'bang'bang'mian
汉中米皮	han'zhong'mi'pi
汉斯干啤	han'si'gan'pi
汉生胶	han'sheng'jiao
江北花生粘	jiang'bei'hua'sheng'zhan
江华毛尖	jiang'hua'mao'jian
江山绿牡丹茶	jiang'shan'lv'mu'dan'cha
江帆牌巧克力酒心糖	jiang'fan'pai'qiao'ke'li'jiu'xin'tang
江津米花糖	jiang'jin'mi'hua'tang
江米条	jiang'mi'tiao
江米酿鸭子	jiang'mi'niang'ya'zi
江苏省	jiang'su'sheng
江苏菜	jiang'su'cai
江西省	jiang'xi'sheng
江阴马蹄酥	jiang'yin'ma'ti'su
池塘莲花	chi'tang'lian'hua
汤冷面	tang'leng'mian
汤包	tang'bao
汤圆锅子	tang'yuan'guo'zi
汤岗子矿泉水	tang'gang'zi'kuang'quan'shui
汤爆双脆	tang'bao'shuang'cui
汤皇	tang'huang
汤羊	tang'yang
汽锅鸡	qi'guo'ji
沃凯诺	wo'kai'nuo
沅陵酥糖	yuan'ling'su'tang
沈阳白冰糖	shen'yang'bai'bing'tang
沐丹阳	mu'dan'yang
沙丁鱼烙	sha'ding'yu'lao
沙参心肺汤	sha'shen'xin'fei'tang
沙参排骨	sha'shen'pai'gu
沙参玉竹猪皮汤	sha'shen'yu'zhu'zhu'pi'tang
沙参玉竹老鸭汤	sha'shen'yu'zhu'lao'ya'tang
沙司牛尾	sha'si'niu'wei
沙士	sha'shi
沙式饼干	sha'shi'bing'gan
沙律海鲜卷	sha'lv'hai'xian'juan
沙拉船	sha'la'chuan
沙拉蛋	sha'la'dan
沙拉酱炒鱿鱼卷	sha'la'jiang'chao'you'yu'juan
沙拉酱	sha'la'jiang
沙枣	sha'zao
沙棘汁	sha'ji'zhi
沙棘黄	sha'ji'huang
沙河蛋糕	sha'he'dan'gao
沙湾大盘鸡	sha'wan'da'pan'ji
沙溪凉茶	sha'xi'liang'cha
沙窝椒汁大鱼头	sha'wo'jiao'zhi'da'yu'tou
沙维康	sha'wei'kang
沙舟踏翠	sha'zhou'ta'cui
沙茶牛肉	sha'cha'niu'rou
沙茶牛蒡	sha'cha'niu'bang
沙蒿胶	sha'hao'jiao
沙锅炖吊子	sha'guo'dun'diao'zi
沙锅牛尾	sha'guo'niu'wei
沙锅鱿鱼	sha'guo'you'yu
沛公狗肉	pei'gong'gou'rou
没食子酸丙酯	mei'shi'zi'suan'bing'zhi
沩山毛尖	wei'shan'mao'jian
沫若香茗	mo'ruo'xiang'ming
沱茶	tuo'cha
河内圆茶	he'nei'yuan'cha
河北省	he'bei'sheng
河南省	he'nan'sheng
河水豆花	he'shui'dou'hua
沸腾可乐	fei'teng'ke'le
沸腾羊肉	fei'teng'yang'rou
沸腾鱼	fei'teng'yu
油侵金枪鱼	you'qin'jin'qiang'yu
油条西舌	you'tiao'xi'she
油梨	you'li
油泡腰花	you'pao'yao'hua
油泡鱼青丸	you'pao'yu'qing'wan
油泼辣子	you'po'la'zi
油泼青鱼	you'po'qing'yu
油泼鸡	you'po'ji
油泼麺	you'po'mian
油浸腰花	you'jin'yao'hua
油浸蝶鱼	you'jin'die'yu
油浸鲳鱼	you'jin'chang'yu
油淋笋鸡	you'lin'sun'ji
油淋苦瓜	you'lin'ku'gua
油淋鸡	you'lin'ji
油淋鸽子	you'lin'ge'zi
油炸糖麻饼	you'zha'tang'ma'bing
油焖凤尾鱼	you'men'feng'wei'yu
油焖大虾	you'men'da'xia
油焖春笋	you'men'chun'sun
油焖白菜	you'men'bai'cai
油焖竹笋	you'men'zhu'sun
油焖鲜蘑	you'men'xian'mo
油煎南瓜饼	you'jian'nan'gua'bing
油煎茄片	you'jian'qie'pian
油煎鸡蛋蘸蜂蜜	you'jian'ji'dan'zhan'feng'mi
油爆双脆	you'bao'shuang'cui
油爆双鲜	you'bao'shuang'xian
油爆小虾	you'bao'xiao'xia
油爆肚尖	you'bao'du'jian
油爆肚花	you'bao'du'hua
油爆虾	you'bao'xia
油爆鱼芹	you'bao'yu'qin
油爆鱿鱼卷	you'bao'you'yu'juan
油爆鲜贝	you'bao'xian'bei
油爆鸭舌	you'bao'ya'she
油甘子	you'gan'zi
油糕	you'gao
油葵	you'kui
油豆腐镶肉	you'dou'fu'xiang'rou
油酥小水果	you'su'xiao'shui'guo
油酸	you'suan
油醋汁	you'cu'zhi
油闷春笋	you'men'chun'sun
油馍馍	you'mo'mo
油鸡纵	you'ji'zong
沾益小粑粑	zhan'yi'xiao'ba'ba
沾益粑粑	zhan'yi'ba'ba
泉水焖鲩鱼	quan'shui'men'huan'yu
泉水鸡	quan'shui'ji
法国红磨坊	fa'guo'hong'mo'fang
法式乳酪月饼	fa'shi'ru'lao'yue'bing
法式乳酪蛋糕	fa'shi'ru'lao'dan'gao
法式桃子布丁	fa'shi'tao'zi'bu'ding
法式牛油炸鱼	fa'shi'niu'you'zha'yu
法棍	fa'gun
法餐	fa'can
法香	fa'xiang
泡凤爪	pao'feng'zhao
泡椒乳鸽	pao'jiao'ru'ge
泡椒响螺片	pao'jiao'xiang'luo'pian
泡椒墨鱼仔	pao'jiao'mo'yu'zai
泡椒田鸡	pao'jiao'tian'ji
泡椒蒸水鱼	pao'jiao'zheng'shui'yu
泡椒鸡片	pao'jiao'ji'pian
泡椒黄辣丁	pao'jiao'huang'la'ding
泡芙	pao'fu
泡菜炒肉末	pao'cai'chao'rou'mo
泡菜爆河虾	pao'cai'bao'he'xia
泡菜肉末	pao'cai'rou'mo
泡菜鱼	pao'cai'yu
泡菜鹅肠	pao'cai'e'chang
泡菜	pao'cai
泡馍	pao'mo
波士顿派	bo'shi'dun'pai
波波糖	bo'bo'tang
波莱城堡	bo'lai'cheng'bao
泥蒜炒年糕	ni'suan'chao'nian'gao
泥鳅钻豆腐	ni'qiu'zuan'dou'fu
泮塘马蹄糕	pan'tang'ma'ti'gao
泰和乌鸡	tai'he'wu'ji
泰国炸鱼	tai'guo'zha'yu
泰安油煎包	tai'an'you'jian'bao
泰安煎饼	tai'an'jian'bing
泰山女儿茶	tai'shan'nv'er'cha
泰德马帝	tai'de'ma'di
泸州老窖	lu'zhou'lao'jiao
泽合	ze'he
洋参银耳炖燕窝	yang'shen'yin'er'dun'yan'wo
洋参雪耳炖燕窝	yang'shen'xue'er'dun'yan'wo
洋姑娘	yang'gu'niang
洋河敦煌	yang'he'dun'huang
洋河	yang'he
洋烧排骨	yang'shao'pai'gu
洋芋檫檫	yang'yu'cha'cha
洋芋粑粑	yang'yu'ba'ba
洋茉莉醛	yang'mo'li'quan
洋葱汤	yang'cong'tang
洋葱泥罐头	yang'cong'ni'guan'tou
洋葱炒蛋	yang'cong'chao'dan
洋葱炒鳝糊	yang'cong'chao'shan'hu
洋葱酱	yang'cong'jiang
洗沙白酥	xi'sha'bai'su
洛神花果酱	luo'shen'hua'guo'jiang
洛神花茶	luo'shen'hua'cha
洛神荷叶茶	luo'shen'he'ye'cha
洞庭水岸	dong'ting'shui'an
洞庭金龟	dong'ting'jin'gui
洞顶乌龙	dong'ding'wu'long
津兆尹	jin'zhao'yin
津八件	jin'ba'jian
津威	jin'wei
洪江鸭	hong'jiang'ya
洪湖蛋糕	hong'hu'dan'gao
洪都鸡	hong'du'ji
洱海弓鱼	er'hai'gong'yu
洱海海菜	er'hai'hai'cai
活性钙	huo'xing'gai
活血药酒	huo'xue'yao'jiu
流黄青蟹	liu'huang'qing'xie
浅色海鲜豉油	qian'se'hai'xian'chi'you
浆水鱼鱼	jiang'shui'yu'yu
浆水麺	jiang'shui'mian
济南蜜三刀	ji'nan'mi'san'dao
济生健美晶	ji'sheng'jian'mei'jing
浏阳茴饼	liu'yang'hui'bing
浑婆鱼头	hun'po'yu'tou
浓汁鹌鹑蛋	nong'zhi'an'chun'dan
浓缩果汁	nong'suo'guo'zhi
浓缩果酱	nong'suo'guo'jiang
浓香鸡块	nong'xiang'ji'kuai
浙江省	zhe'jiang'sheng
浙菜	zhe'cai
浦江蟹羹	pu'jiang'xie'geng
浪花天香鱼	lang'hua'tian'xiang'yu
浮油鸡片	fu'you'ji'pian
海东雪梨	hai'dong'xue'li
海兔酱	hai'tu'jiang
海南椰丝包	hai'nan'ye'si'bao
海南椰子船	hai'nan'ye'zi'chuan
海南液体茶	hai'nan'ye'ti'cha
海南煎粽	hai'nan'jian'zong
海南罐装饮料	hai'nan'guan'zhuang'yin'liao
海南萝卜糕	hai'nan'luo'bo'gao
海参什锦肉片	hai'shen'shi'jin'rou'pian
海参木耳汤	hai'shen'mu'er'tang
海参武昌鱼	hai'shen'wu'chang'yu
海参炖瘦肉	hai'shen'dun'shou'rou
海参眉毛肉丸	hai'shen'mei'mao'rou'wan
海参碗鱼	hai'shen'wan'yu
海参羹	hai'shen'geng
海参肉饼	hai'shen'rou'bing
海参肘子	hai'shen'zhou'zi
海参饼	hai'shen'bing
海味豆腐汤	hai'wei'dou'fu'tang
海天上等蚝油	hai'tian'shang'deng'hao'you
海天叉烧酱	hai'tian'cha'shao'jiang
海天味极鲜	hai'tian'wei'ji'xian
海天海鲜酱油	hai'tian'hai'xian'jiang'you
海天海鲜酱	hai'tian'hai'xian'jiang
海天特级草菇老抽	hai'tian'te'ji'cao'gu'lao'chou
海天老抽王	hai'tian'lao'chou'wang
海天老抽豉油皇	hai'tian'lao'chou'chi'you'huang
海天草菇老抽	hai'tian'cao'gu'lao'chou
海天蒸鱼豉油	hai'tian'zheng'yu'chi'you
海天金标生抽	hai'tian'jin'biao'sheng'chou
海天锦上鲜叉烧酱	hai'tian'jin'shang'xian'cha'shao'jiang
海天锦上鲜排骨酱	hai'tian'jin'shang'xian'pai'gu'jiang
海天鲜味生抽	hai'tian'xian'wei'sheng'chou
海天黄豆酱	hai'tian'huang'dou'jiang
海带丝	hai'dai'si
海带清热汤	hai'dai'qing're'tang
海带焖饭	hai'dai'men'fan
海带猪骨汤	hai'dai'zhu'gu'tang
海带结	hai'dai'jie
海带茶	hai'dai'cha
海带萝卜汤	hai'dai'luo'bo'tang
海带	hai'dai
海棠果	hai'tang'guo
海棠汤鲍王	hai'tang'tang'bao'wang
海水煮海鱼	hai'shui'zhu'hai'yu
海盐	hai'yan
海米冬瓜	hai'mi'dong'gua
海米拌油菜	hai'mi'ban'you'cai
海米拌莴笋	hai'mi'ban'wo'sun
海米拌菜花	hai'mi'ban'cai'hua
海米拌黄瓜	hai'mi'ban'huang'gua
海米烧茄子	hai'mi'shao'qie'zi
海米烧茄	hai'mi'shao'qie
海米烧菜花	hai'mi'shao'cai'hua
海米烧萝卜	hai'mi'shao'luo'bo
海米珍珠笋	hai'mi'zhen'zhu'sun
海米白菜汤	hai'mi'bai'cai'tang
海米萝卜汤	hai'mi'luo'bo'tang
海米豇豆	hai'mi'jiang'dou
海绵果酱卷	hai'mian'guo'jiang'juan
海绵糕	hai'mian'gao
海绵蛋糕	hai'mian'dan'gao
海苔戚风	hai'tai'qi'feng
海萝胶	hai'luo'jiao
海藻酸丙二醇酯	hai'zao'suan'bing'er'chun'zhi
海藻酸钠	hai'zao'suan'na
海藻酸钾	hai'zao'suan'jia
海蛰腰花	hai'zhe'yao'hua
海蜇头子	hai'zhe'tou'zi
海蜇火腿羹	hai'zhe'huo'tui'geng
海蜇皮子	hai'zhe'pi'zi
海蜇	hai'zhe
海螺罐头	hai'luo'guan'tou
海蟑螂	hai'zhang'lang
海陆煲	hai'lu'bao
海马宫茶	hai'ma'gong'cha
海鲜大烩	hai'xian'da'hui
海鲜拼盘	hai'xian'pin'pan
海鲜汤	hai'xian'tang
海鲜特级一品鲜酱油	hai'xian'te'ji'yi'pin'xian'jiang'you
海鲜豆腐羹	hai'xian'dou'fu'geng
海鲜铁锅烧	hai'xian'tie'guo'shao
海鲫鱼	hai'ji'yu
消暑养生茶	xiao'shu'yang'sheng'cha
消泡剂	xiao'pao'ji
涌溪火青	yong'xi'huo'qing
涟水鸡糕	lian'shui'ji'gao
润明	run'ming
润燥黄豆肉排汤	run'zao'huang'dou'rou'pai'tang
润肠保健茶	run'chang'bao'jian'cha
润肺菜干汤	run'fei'cai'gan'tang
液体石蜡	ye'ti'shi'la
淀粉磷酸酯钠	dian'fen'lin'suan'zhi'na
淀粉软糖	dian'fen'ruan'tang
淀粉酶	dian'fen'mei
淀粉	dian'fen
淋糖擘酥	lin'tang'bo'su
淡奶油北海道土司	dan'nai'you'bei'hai'dao'tu'si
淡奶油芝麻餐包	dan'nai'you'zhi'ma'can'bao
淡奶油	dan'nai'you
淡糟香螺片	dan'zao'xiang'luo'pian
淡菜炖麻雀	dan'cai'dun'ma'que
淡菜紫菜瘦肉汤	dan'cai'zi'cai'shou'rou'tang
淮安茶馓	huai'an'cha'san
淮山芡实炖鱼肚	huai'shan'qian'shi'dun'yu'du
淮山薏苡仁萝卜粥	huai'shan'yi'yi'ren'luo'bo'zhou
淮扬春卷	huai'yang'chun'juan
淮杞浸乌鸡	huai'qi'jin'wu'ji
淮杞炖羊肉	huai'qi'dun'yang'rou
淮杞鸡脚响螺汤	huai'qi'ji'jiao'xiang'luo'tang
淳安猕猴桃	chun'an'mi'hou'tao
混合胡椒粉	hun'he'hu'jiao'fen
添之彩顶好大红色素	tian'zhi'cai'ding'hao'da'hong'se'su
添之彩顶好日落红色素	tian'zhi'cai'ding'hao'ri'luo'hong'se'su
添之彩顶好日落黄色素	tian'zhi'cai'ding'hao'ri'luo'huang'se'su
添之彩顶好柠檬黄色素	tian'zhi'cai'ding'hao'ning'meng'huang'se'su
添之彩顶好橙红色素	tian'zhi'cai'ding'hao'cheng'hong'se'su
添之彩顶好橙黄色素	tian'zhi'cai'ding'hao'cheng'huang'se'su
添之彩顶好胭脂红色素	tian'zhi'cai'ding'hao'yan'zhi'hong'se'su
添之彩顶好苹果绿色素	tian'zhi'cai'ding'hao'ping'guo'lv'se'su
添乐添寿	tian'le'tian'shou
清净园午餐肉	qing'jing'yuan'wu'can'rou
清凉果签	qing'liang'guo'qian
清凉的钵仔糕	qing'liang'de'bo'zai'gao
清华斋糕点	qing'hua'zhai'gao'dian
清咽茶	qing'yan'cha
清宫细点	qing'gong'xi'dian
清新茵陈茶	qing'xin'yin'chen'cha
清水滑子蘑罐头	qing'shui'hua'zi'mo'guan'tou
清水白菜	qing'shui'bai'cai
清水鲜人参罐头	qing'shui'xian'ren'shen'guan'tou
清江鱼茄子煲	qing'jiang'yu'qie'zi'bao
清汤冬瓜	qing'tang'dong'gua
清汤圆子	qing'tang'yuan'zi
清汤柳叶燕菜	qing'tang'liu'ye'yan'cai
清汤柴把鸭	qing'tang'chai'ba'ya
清汤炸肚	qing'tang'zha'du
清汤燕菜	qing'tang'yan'cai
清汤牛腩	qing'tang'niu'nan
清汤玉带鸡	qing'tang'yu'dai'ji
清汤米线	qing'tang'mi'xian
清汤菊花鱼	qing'tang'ju'hua'yu
清汤银耳素鸽蛋	qing'tang'yin'er'su'ge'dan
清汤银耳	qing'tang'yin'er
清汤饵丝	qing'tang'er'si
清汤鱼圆	qing'tang'yu'yuan
清汤鱼翅	qing'tang'yu'chi
清汤鱼	qing'tang'yu
清汤鲍鱼	qing'tang'bao'yu
清润养肺汤	qing'run'yang'fei'tang
清炒三丁	qing'chao'san'ding
清炒海蚌	qing'chao'hai'bang
清炒芦笋	qing'chao'lu'sun
清炒虾仁	qing'chao'xia'ren
清炒蚕豆	qing'chao'can'dou
清炒鳝丝	qing'chao'shan'si
清炒鸭掌	qing'chao'ya'zhang
清炖兔子	qing'dun'tu'zi
清炖全鸡	qing'dun'quan'ji
清炖武山鸡	qing'dun'wu'shan'ji
清炖狼山鸡	qing'dun'lang'shan'ji
清炖甲鱼	qing'dun'jia'yu
清炖羊肉	qing'dun'yang'rou
清炖萝卜牛肉	qing'dun'luo'bo'niu'rou
清炖蚌肉	qing'dun'bang'rou
清炖蟹粉狮子头	qing'dun'xie'fen'shi'zi'tou
清炸鹌鹑	qing'zha'an'chun
清炸麻雀	qing'zha'ma'que
清炸黄河刀鱼	qing'zha'huang'he'dao'yu
清爽美颜茶	qing'shuang'mei'yan'cha
清真什锦细点	qing'zhen'shi'jin'xi'dian
清真桂花茶饼	qing'zhen'gui'hua'cha'bing
清真酱牛肉	qing'zhen'jiang'niu'rou
清肠胃热汤	qing'chang'wei're'tang
清蒸八宝猪	qing'zheng'ba'bao'zhu
清蒸冬瓜鸡块	qing'zheng'dong'gua'ji'kuai
清蒸刀鱼	qing'zheng'dao'yu
清蒸加吉鱼	qing'zheng'jia'ji'yu
清蒸哈什蚂	qing'zheng'ha'shi'ma
清蒸杞甲鱼	qing'zheng'qi'jia'yu
清蒸桂鱼	qing'zheng'gui'yu
清蒸武昌鱼	qing'zheng'wu'chang'yu
清蒸江团	qing'zheng'jiang'tuan
清蒸火腿	qing'zheng'huo'tui
清蒸甲鱼	qing'zheng'jia'yu
清蒸白鳝	qing'zheng'bai'shan
清蒸石斑鱼	qing'zheng'shi'ban'yu
清蒸翅子	qing'zheng'chi'zi
清蒸荷包红鲤鱼	qing'zheng'he'bao'hong'li'yu
清蒸西瓜鸡	qing'zheng'xi'gua'ji
清蒸青鳝	qing'zheng'qing'shan
清蒸鲈鱼	qing'zheng'lu'yu
清蒸鲥鱼	qing'zheng'shi'yu
清蒸鲩鱼	qing'zheng'huan'yu
清蒸鲻鱼	qing'zheng'zi'yu
清蒸鸭子	qing'zheng'ya'zi
清蒸鹌鹑	qing'zheng'an'chun
清蒸鹰龟	qing'zheng'ying'gui
清补凉乳鸽汤	qing'bu'liang'ru'ge'tang
清补凉煲莲子鱼尾汤	qing'bu'liang'bao'lian'zi'yu'wei'tang
清补羊肉汤	qing'bu'yang'rou'tang
清酒	qing'jiu
清音茶	qing'yin'cha
清风送爽	qing'feng'song'shuang
清香砂焐鸡	qing'xiang'sha'wu'ji
渌江牌圆蛋糕	lu'jiang'pai'yuan'dan'gao
渝食渝香	yu'shi'yu'xiang
渠江	qu'jiang
温州黄汤茶	wen'zhou'huang'tang'cha
温江酥糖	wen'jiang'su'tang
温泉菜	wen'quan'cai
温泉蛋	wen'quan'dan
温泉鸡	wen'quan'ji
温酒醉虾	wen'jiu'zui'xia
渭南水晶饼	wei'nan'shui'jing'bing
港汇笋尖虾皇饺	gang'hui'sun'jian'xia'huang'jiao
港红	gang'hong
湄江茶和美体茶	mei'jiang'cha'he'mei'ti'cha
湖北省	hu'bei'sheng
湖南省	hu'nan'sheng
湖南菜	hu'nan'cai
湖州肉粽	hu'zhou'rou'zong
湘式酥点	xiang'shi'su'dian
湘江鲫鱼	xiang'jiang'ji'yu
湘莲罐头	xiang'lian'guan'tou
湘菜	xiang'cai
湛江威化饼	zhan'jiang'wei'hua'bing
湛江鸡	zhan'jiang'ji
湿热肝炎马齿苋汤	shi're'gan'yan'ma'chi'xian'tang
源和堂蜜饯	yuan'he'tang'mi'jian
源通	yuan'tong
溜牛里脊	liu'niu'li'ji
溜肝尖	liu'gan'jian
溜腰花	liu'yao'hua
溜藕片	liu'ou'pian
溜黄菜	liu'huang'cai
溴酸钾	xiu'suan'jia
滇八件糕点	dian'ba'jian'gao'dian
滇八件	dian'ba'jian
滇味炒面	dian'wei'chao'mian
滇红茶	dian'hong'cha
滇绿	dian'lv
滑嫰黄金木瓜布丁	hua'nen'huang'jin'mu'gua'bu'ding
滑溜鹌鹑	hua'liu'an'chun
滑炒山药	hua'chao'shan'yao
滑石粉	hua'shi'fen
滑肉白菜	hua'rou'bai'cai
滑肉莴笋	hua'rou'wo'sun
滑肉	hua'rou
滑蛋牛肉	hua'dan'niu'rou
滑蛋虾仁	hua'dan'xia'ren
满台飞	man'tai'fei
满城香	man'cheng'xiang
满堂水煮鱼	man'tang'shui'zhu'yu
满汉全席	man'han'quan'xi
滦河米糖	luan'he'mi'tang
漂白剂	piao'bai'ji
漆油炒米酒	qi'you'chao'mi'jiu
漆油炖鸡	qi'you'dun'ji
漆油米酒	qi'you'mi'jiu
漆蜡妙食	qi'la'miao'shi
漾濞核桃	yang'bi'he'tao
潇湘五元龟	xiao'xiang'wu'yuan'gui
潇湘猪手	xiao'xiang'zhu'shou
潘趣酒	pan'qu'jiu
潮州烧雁鹅	chao'zhou'shao'yan'e
潮州白酸菜	chao'zhou'bai'suan'cai
潮州肉冻	chao'zhou'rou'dong
潮式老婆饼	chao'shi'lao'po'bing
潮糕	chao'gao
潼关鲶鱼汤	tong'guan'nian'yu'tang
潼川豆豉	tong'chuan'dou'chi
澳大利亚的芒果	ao'da'li'ya'de'mang'guo
澳洲万格红	ao'zhou'wan'ge'hong
澳洲带子	ao'zhou'dai'zi
激情海岸	ji'qing'hai'an
灌汤包	guan'tang'bao
灌汤小笼包	guan'tang'xiao'long'bao
灌汤龙凤球	guan'tang'long'feng'qiu
灌肺	guan'fei
灌蟹鱼圆	guan'xie'yu'yuan
火山鸣泉	huo'shan'ming'quan
火山鸣	huo'shan'ming
火晶柿子	huo'jing'shi'zi
火炙糕	huo'zhi'gao
火炼金身	huo'lian'jin'shen
火烧头尾	huo'shao'tou'wei
火热香辣蟹	huo're'xiang'la'xie
火焗鸭	huo'ju'ya
火爆双脆	huo'bao'shuang'cui
火爆肚头	huo'bao'du'tou
火爆腰块	huo'bao'yao'kuai
火爆腰花	huo'bao'yao'hua
火爆荔枝腰	huo'bao'li'zhi'yao
火腿土司	huo'tui'tu'si
火腿大头菜酥	huo'tui'da'tou'cai'su
火腿炒茄瓜	huo'tui'chao'qie'gua
火腿炖甲鱼	huo'tui'dun'jia'yu
火腿白菜	huo'tui'bai'cai
火腿萝卜丝汤	huo'tui'luo'bo'si'tang
火腿萝卜饼	huo'tui'luo'bo'bing
火腿豆焖饭	huo'tui'dou'men'fan
火腿豆豉	huo'tui'dou'chi
火腿酥腰	huo'tui'su'yao
火腿风味腌制料	huo'tui'feng'wei'yan'zhi'liao
火腿饼	huo'tui'bing
火腿鱼	huo'tui'yu
火腿鸡丝卷	huo'tui'ji'si'juan
火腿鸡杂饵丝	huo'tui'ji'za'er'si
火锅粉	huo'guo'fen
火鞭牛肉	huo'bian'niu'rou
火龙果	huo'long'guo
灯影牛肉干	deng'ying'niu'rou'gan
灯影牛肉	deng'ying'niu'rou
灯影苕片	deng'ying'shao'pian
灯笼泡椒	deng'long'pao'jiao
灯芯糕	deng'xin'gao
灯草糕	deng'cao'gao
灰树花保健饮料	hui'shu'hua'bao'jian'yin'liao
灰树	hui'shu
灵芝恋玉蝉	ling'zhi'lian'yu'chan
灵芝甘草茶	ling'zhi'gan'cao'cha
灵芝茶	ling'zhi'cha
灵芝饮料	ling'zhi'yin'liao
炉猪	lu'zhu
炉鸭	lu'ya
炊石榴鸡	chui'shi'liu'ji
炊米麸肉	chui'mi'fu'rou
炊莲花鸡	chui'lian'hua'ji
炊麒麟鱼	chui'qi'lin'yu
炒丝瓜	chao'si'gua
炒二冬	chao'er'dong
炒凉粉	chao'liang'fen
炒凤尾虾排	chao'feng'wei'xia'pai
炒四宝	chao'si'bao
炒大明虾	chao'da'ming'xia
炒山药泥	chao'shan'yao'ni
炒桂花翅	chao'gui'hua'chi
炒榛子酱	chao'zhen'zi'jiang
炒海蜇	chao'hai'zhe
炒玉米	chao'yu'mi
炒番茄鸡片	chao'fan'qie'ji'pian
炒疙瘩	chao'ge'da
炒白虾	chao'bai'xia
炒白鸽	chao'bai'ge
炒碧桃里脊	chao'bi'tao'li'ji
炒禾花雀	chao'he'hua'que
炒米粉	chao'mi'fen
炒米线	chao'mi'xian
炒米	chao'mi
炒素腰花	chao'su'yao'hua
炒绵羊丝	chao'mian'yang'si
炒羊肚丝	chao'yang'du'si
炒肉丝	chao'rou'si
炒肉片儿	chao'rou'pian'er
炒肝尖儿	chao'gan'jian'er
炒肝片	chao'gan'pian
炒胡萝卜酱	chao'hu'luo'bo'jiang
炒腰脑	chao'yao'nao
炒芙蓉蟹	chao'fu'rong'xie
炒茄丝	chao'qie'si
炒萝卜	chao'luo'bo
炒葱椒鸡	chao'cong'jiao'ji
炒虾丝	chao'xia'si
炒蟹肉	chao'xie'rou
炒西兰花	chao'xi'lan'hua
炒西施舌	chao'xi'shi'she
炒豆腐松	chao'dou'fu'song
炒豆腐脑	chao'dou'fu'nao
炒豇豆	chao'jiang'dou
炒豌豆夹	chao'wan'dou'jia
炒豌豆酱	chao'wan'dou'jiang
炒豌豆	chao'wan'dou
炒蹄筋儿	chao'ti'jin'er
炒里脊丝	chao'li'ji'si
炒面线	chao'mian'xian
炒面鱼	chao'mian'yu
炒面	chao'mian
炒韭菜青虾	chao'jiu'cai'qing'xia
炒饵丝	chao'er'si
炒饵块	chao'er'kuai
炒鲜莴笋	chao'xian'wo'sun
炒鸡丝	chao'ji'si
炒鸡什件	chao'ji'shi'jian
炒鸡米	chao'ji'mi
炒鸭肠	chao'ya'chang
炒麦穗花鱿	chao'mai'sui'hua'you
炒黄瓜酱	chao'huang'gua'jiang
炕炕馍	kang'kang'mo
炖人参汤	dun'ren'shen'tang
炖健身全鸭	dun'jian'shen'quan'ya
炖口蘑龙凤珠	dun'kou'mo'long'feng'zhu
炖吊子	dun'diao'zi
炖柠檬鸭	dun'ning'meng'ya
炖橄榄螺头汤	dun'gan'lan'luo'tou'tang
炖牛掌	dun'niu'zhang
炖禾虫	dun'he'chong
炖羊肉	dun'yang'rou
炖肉	dun'rou
炖菜核	dun'cai'he
炖豆腐猪蹄香菇	dun'dou'fu'zhu'ti'xiang'gu
炖鸡汁	dun'ji'zhi
炝冬笋	qiang'dong'sun
炝土豆丝	qiang'tu'dou'si
炝炒西兰花	qiang'chao'xi'lan'hua
炝糟五花肉	qiang'zao'wu'hua'rou
炝羊肚青椒	qiang'yang'du'qing'jiao
炝肉	qiang'rou
炝茭白	qiang'jiao'bai
炝豆腐	qiang'dou'fu
炝辣黄瓜条	qiang'la'huang'gua'tiao
炝青蛤	qiang'qing'ge
炝鱿鱼卷	qiang'you'yu'juan
炝黄瓜条	qiang'huang'gua'tiao
炝黄瓜	qiang'huang'gua
炸丸子	zha'wan'zi
炸佛手通脊	zha'fo'shou'tong'ji
炸元宵	zha'yuan'xiao
炸八块	zha'ba'kuai
炸冬瓜丸子	zha'dong'gua'wan'zi
炸南瓜条	zha'nan'gua'tiao
炸吉利排骨	zha'ji'li'pai'gu
炸土豆片	zha'tu'dou'pian
炸大扁	zha'da'bian
炸子鸡	zha'zi'ji
炸排骨	zha'pai'gu
炸春卷	zha'chun'juan
炸梨球	zha'li'qiu
炸灌汤丸子	zha'guan'tang'wan'zi
炸烹鲈鱼腩	zha'peng'lu'yu'nan
炸熘黄鱼	zha'liu'huang'yu
炸珍珠虾	zha'zhen'zhu'xia
炸班指	zha'ban'zhi
炸石鸡	zha'shi'ji
炸糯米鸡	zha'nuo'mi'ji
炸素鸟或菊花	zha'su'niao'huo'ju'hua
炸素鸡排	zha'su'ji'pai
炸肉骨碌烹	zha'rou'gu'lu'peng
炸肥肠	zha'fei'chang
炸脂盖	zha'zhi'gai
炸芝麻里脊	zha'zhi'ma'li'ji
炸茄盒	zha'qie'he
炸茄饼	zha'qie'bing
炸菠菜脯	zha'bo'cai'pu
炸蒸肉	zha'zheng'rou
炸藕盒	zha'ou'he
炸虾饼	zha'xia'bing
炸蚕蛹鸡	zha'can'yong'ji
炸豆腐丸子	zha'dou'fu'wan'zi
炸豆腐芝士	zha'dou'fu'zhi'shi
炸豆腐	zha'dou'fu
炸酱面	zha'jiang'mian
炸面筋	zha'mian'jin
炸香蕉卷	zha'xiang'jiao'juan
炸鱼丸	zha'yu'wan
炸鱼卷	zha'yu'juan
炸鳝段	zha'shan'duan
炸鸡排	zha'ji'pai
炸鸡肉串	zha'ji'rou'chuan
炸鸡葫芦	zha'ji'hu'lu
炸鸳鸯嘎渣	zha'yuan'yang'ga'zha
炸鹿尾儿	zha'lu'wei'er
炼奶咖啡蛋	lian'nai'ka'fei'dan
烀肉	hu'rou
烘蛋角	hong'dan'jiao
烙司松饼	lao'si'song'bing
烙糕子	lao'gao'zi
烟熏三文鱼	yan'xun'san'wen'yu
烟熏排骨	yan'xun'pai'gu
烟酰胺	yan'xian'an
烟酸	yan'suan
烤乳猪	kao'ru'zhu
烤兔肉	kao'tu'rou
烤全羊	kao'quan'yang
烤南瓜汤配牛油曲奇饼	kao'nan'gua'tang'pei'niu'you'qu'qi'bing
烤奶油香蕉	kao'nai'you'xiang'jiao
烤小猪	kao'xiao'zhu
烤小鸡	kao'xiao'ji
烤扁担肉	kao'bian'dan'rou
烤牌子	kao'pai'zi
烤牛骨	kao'niu'gu
烤羊肉串	kao'yang'rou'chuan
烤羊肉	kao'yang'rou
烤羊腿	kao'yang'tui
烤肉	kao'rou
烤花揽桂鱼	kao'hua'lan'gui'yu
烤花揽鳜鱼	kao'hua'lan'gui'yu
烤茶	kao'cha
烤蛋方糕	kao'dan'fang'gao
烤豆腐	kao'dou'fu
烤面包盒	kao'mian'bao'he
烤鳗鱼鸡蛋卷	kao'man'yu'ji'dan'juan
烤鸡肉串	kao'ji'rou'chuan
烤麸大包	kao'fu'da'bao
烤黄蛋糕	kao'huang'dan'gao
烧三不粘	shao'san'bu'zhan
烧卖酥	shao'mai'su
烧填鸭	shao'tian'ya
烧子鹅	shao'zi'e
烧心	shao'xin
烧桂花肠	shao'gui'hua'chang
烧汁煎生蚝	shao'zhi'jian'sheng'hao
烧汁	shao'zhi
烧烤类香料	shao'kao'lei'xiang'liao
烧瓤菜花	shao'rang'cai'hua
烧瓤鲜沙虫	shao'rang'xian'sha'chong
烧白	shao'bai
烧百合	shao'bai'he
烧罗汉面筋	shao'luo'han'mian'jin
烧羊肉	shao'yang'rou
烧肉	shao'rou
烧肺	shao'fei
烧臆子	shao'yi'zi
烧花鸭	shao'hua'ya
烧茄子	shao'qie'zi
烧萝卜	shao'luo'bo
烧豆腐	shao'dou'fu
烧雏鸡	shao'chu'ji
烧饵块	shao'er'kuai
烧鱼头	shao'yu'tou
烧鹅仔	shao'e'zai
烩三丝鱼翅	hui'san'si'yu'chi
烩乌龟蛋	hui'wu'gui'dan
烩散丹	hui'san'dan
烩海参	hui'hai'shen
烩白菜	hui'bai'cai
烩肥肠	hui'fei'chang
烩蟹肉	hui'xie'rou
烩豌豆	hui'wan'dou
烩酸菜	hui'suan'cai
烩金银丝	hui'jin'yin'si
烩银丝	hui'yin'si
烩银耳	hui'yin'er
烩鸭四宝	hui'ya'si'bao
烩鸭腰儿	hui'ya'yao'er
热奶茶	re'nai'cha
热带暴风雨	re'dai'bao'feng'yu
热带杂果罐头	re'dai'za'guo'guan'tou
热水藕	re'shui'ou
热河露	re'he'lu
热白豆腐	re'bai'dou'fu
热酒	re'jiu
热面皮	re'mian'pi
烹白肉	peng'bai'rou
焖大虾	men'da'xia
焖扁豆	men'bian'dou
焖煮火腿白菜	men'zhu'huo'tui'bai'cai
焖白鳝	men'bai'shan
焖笋	men'sun
焖茄子条	men'qie'zi'tiao
焖鱼头	men'yu'tou
焖黄鳝	men'huang'shan
焦亚硫酸钠	jiao'ya'liu'suan'na
焦亚硫酸钾	jiao'ya'liu'suan'jia
焦圈	jiao'quan
焦溜肥肠	jiao'liu'fei'chang
焦盖烧饼	jiao'gai'shao'bing
焦磷酸二氢二钠	jiao'lin'suan'er'qing'er'na
焦磷酸钠	jiao'lin'suan'na
焦糖奶油吐司	jiao'tang'nai'you'tu'si
焦糖布丁	jiao'tang'bu'ding
焦糖泡芙	jiao'tang'pao'fu
焦糖色	jiao'tang'se
焦糖	jiao'tang
焯炒腰花	chao'chao'yao'hua
煌佳	huang'jia
煎丸子	jian'wan'zi
煎云吞	jian'yun'tun
煎封鲳鱼	jian'feng'chang'yu
煎扒鲭鱼头尾	jian'ba'qing'yu'tou'wei
煎茄片	jian'qie'pian
煎蒸黄鱼	jian'zheng'huang'yu
煎豆腐鱼烙	jian'dou'fu'yu'lao
煎转鲫鱼	jian'zhuan'ji'yu
煎软鸡	jian'ruan'ji
煎连壳蟹	jian'lian'ke'xie
煎酿斑鸠	jian'niang'ban'jiu
煎酿茄子	jian'niang'qie'zi
煎金钱牛柳	jian'jin'qian'niu'liu
煎雏肉	jian'chu'rou
煎饼果子	jian'bing'guo'zi
煎饼	jian'bing
煎鹅肝	jian'e'gan
煨烤桂鱼	wei'kao'gui'yu
煨牛肉月饼	wei'niu'rou'yue'bing
煮饽饽锅子	zhu'bo'bo'guo'zi
煲仔鱼丸	bao'zai'yu'wan
煲仔鱼丸	bao'zi'yu'wan
煲猪肉汤	bao'zhu'rou'tang
煸馅水饺	bian'xian'shui'jiao
熊掌豆腐	xiong'zhang'dou'fu
熊猫品竹	xiong'mao'pin'zhu
熊猫蟹肉	xiong'mao'xie'rou
熏挪威鲑鱼小塔	xun'nuo'wei'gui'yu'xiao'ta
熏肘子	xun'zhou'zi
熏肠	xun'chang
熏鸡白肚儿	xun'ji'bai'du'er
熘土豆丝	liu'tu'dou'si
熘白蘑	liu'bai'mo
熘蟹肉	liu'xie'rou
熘豆芽	liu'dou'ya
熘鱼焙面	liu'yu'bei'mian
熘鱼片儿	liu'yu'pian'er
熘鱼肚	liu'yu'du
熘鱼脯	liu'yu'pu
熘鲜蘑	liu'xian'mo
熟地山药粥	shu'di'shan'yao'zhou
熟菜油	shu'cai'you
熬黄花鱼	ao'huang'hua'yu
燎花	liao'hua
燕尾桃花	yan'wei'tao'hua
燕皮	yan'pi
燕禾金	yan'he'jin
燕窝四字	yan'wo'si'zi
燕窝炖雪梨	yan'wo'dun'xue'li
燕窝粥	yan'wo'zhou
燕窝酥	yan'wo'su
燕麦片	yan'mai'pian
爆三样儿	bao'san'yang'er
爆三样	bao'san'yang
爆三脆	bao'san'cui
爆两样	bao'liang'yang
爆人参鸡片	bao'ren'shen'ji'pian
爆墨鱼卷	bao'mo'yu'juan
爆墨鱼花	bao'mo'yu'hua
爆氽	bao'tun
爆炒羊肚	bao'chao'yang'du
爆炒肉片	bao'chao'rou'pian
爆炒腰花	bao'chao'yao'hua
爆炒鳝片	bao'chao'shan'pian
爆竹鸡	bao'zhu'ji
爆肚仁儿	bao'du'ren'er
爆肚	bao'du
爆腰花	bao'yao'hua
爆螺片	bao'luo'pian
爆鱼丁	bao'yu'ding
爪哇咖啡	zhao'wa'ka'fei
爱尔兰咖啡	ai'er'lan'ka'fei
爱维	ai'wei
片儿川面	pian'er'chuan'mian
牙签肉	ya'qian'rou
牛乳	niu'ru
牛佛烘肘	niu'fo'hong'zhou
牛外脊	niu'wai'ji
牛头糕	niu'tou'gao
牛奶千层蛋糕	niu'nai'qian'ceng'dan'gao
牛奶咖啡	niu'nai'ka'fei
牛奶土司	niu'nai'tu'si
牛奶朱古力	niu'nai'zhu'gu'li
牛奶煮平菇	niu'nai'zhu'ping'gu
牛奶玉米土司	niu'nai'yu'mi'tu'si
牛奶	niu'nai
牛宝	niu'bao
牛尾汤罐头	niu'wei'tang'guan'tou
牛尾	niu'wei
牛展汤	niu'zhan'tang
牛扒	niu'pa
牛抵茶	niu'di'cha
牛排罐头	niu'pai'guan'tou
牛板筋	niu'ban'jin
牛柳	niu'liu
牛水	niu'shui
牛油果	niu'you'guo
牛油蜜糖玉米	niu'you'mi'tang'yu'mi
牛油	niu'you
牛清汤	niu'qing'tang
牛磺酸	niu'huang'suan
牛筋煲	niu'jin'bao
牛羊肉干层油酥饼	niu'yang'rou'gan'ceng'you'su'bing
牛肉夹馍	niu'rou'jia'mo
牛肉末炒芹菜	niu'rou'mo'chao'qin'cai
牛肉汁	niu'rou'zhi
牛肉泡馍	niu'rou'pao'mo
牛肉焦饼	niu'rou'jiao'bing
牛肉羹	niu'rou'geng
牛肉蔬菜浓汤	niu'rou'shu'cai'nong'tang
牛肉面	niu'rou'mian
牛肉饼	niu'rou'bing
牛肉馅饼	niu'rou'xian'bing
牛肚火锅	niu'du'huo'guo
牛腩煲水煮牛肉	niu'nan'bao'shui'zhu'niu'rou
牛膝炖猪蹄	niu'xi'dun'zhu'ti
牛膝蹄筋	niu'xi'ti'jin
牛舌	niu'she
牛蒡排骨汤	niu'bang'pai'gu'tang
牛蒡沙拉	niu'bang'sha'la
牛蒡糕	niu'bang'gao
牛蒡脆肠	niu'bang'cui'chang
牛蒡茶冻	niu'bang'cha'dong
牛蒡香羹	niu'bang'xiang'geng
牛里脊	niu'li'ji
牛鞭	niu'bian
牛骨	niu'gu
牡丹蝎托	mu'dan'xie'tuo
牡蛎蒸米饭	mu'li'zheng'mi'fan
特丁基对苯二酚	te'ding'ji'dui'ben'er'fen
特制烤肠	te'zhi'kao'chang
特加饼	te'jia'bing
特味果汁糖	te'wei'guo'zhi'tang
特级橄榄油	te'ji'gan'lan'you
特级润城鸡精	te'ji'run'cheng'ji'jing
特级红辣椒	te'ji'hong'la'jiao
特级金标生抽王	te'ji'jin'biao'sheng'chou'wang
特级金标生抽	te'ji'jin'biao'sheng'chou
特级鲜桔汽水	te'ji'xian'ju'qi'shui
犍为酥芙蓉	qian'wei'su'fu'rong
状元卤味	zhuang'yuan'lu'wei
犹太白面包卷	you'tai'bai'mian'bao'juan
狗肉	gou'rou
狮子头	shi'zi'tou
狮子糕	shi'zi'gao
狮球大吉士	shi'qiu'da'ji'shi
狮球小吉士	shi'qiu'xiao'ji'shi
狸便咖啡	li'bian'ka'fei
狼牙生菜	lang'ya'sheng'cai
猕猴桃	mi'hou'tao
猪尾浓汤	zhu'wei'nong'tang
猪手排骨汤	zhu'shou'pai'gu'tang
猪油年糕	zhu'you'nian'gao
猪油百果松糕	zhu'you'bai'guo'song'gao
猪油蒸头松糕	zhu'you'zheng'tou'song'gao
猪肉丸香辛料	zhu'rou'wan'xiang'xin'liao
猪肉韭菜馅水饺	zhu'rou'jiu'cai'xian'shui'jiao
猪肚包鸡	zhu'du'bao'ji
猪肚煲咸菜	zhu'du'bao'xian'cai
猪肚黄芪汤	zhu'du'huang'qi'tang
猪肝枸杞子汤	zhu'gan'gou'qi'zi'tang
猪肝水	zhu'gan'shui
猪肝绿豆粥	zhu'gan'lv'dou'zhou
猪肝菠菜汤	zhu'gan'bo'cai'tang
猪脾枣米粥	zhu'pi'zao'mi'zhou
猪血鱼片粥	zhu'xue'yu'pian'zhou
猪蹄粥	zhu'ti'zhou
猪蹄葱白炖豆腐	zhu'ti'cong'bai'dun'dou'fu
猫儿面	mao'er'mian
猫耳朵	mao'er'duo
猴头四宝	hou'tou'si'bao
猴头菇炖竹丝鸡	hou'tou'gu'dun'zhu'si'ji
猴头菇	hou'tou'gu
猴王牌速溶减肥茶	hou'wang'pai'su'rong'jian'fei'cha
猴蘑牛头方	hou'mo'niu'tou'fang
玄参茶饮	xuan'shen'cha'yin
玄明粉	xuan'ming'fen
玄酒一杯	xuan'jiu'yi'bei
玉信酥	yu'xin'su
玉兔五彩丝	yu'tu'wu'cai'si
玉兔海参	yu'tu'hai'shen
玉兔白菜	yu'tu'bai'cai
玉兰明虾	yu'lan'ming'xia
玉兰片	yu'lan'pian
玉兰牌蛋黄圆	yu'lan'pai'dan'huang'yuan
玉兰花糕	yu'lan'hua'gao
玉带油皇果	yu'dai'you'huang'guo
玉带糕	yu'dai'gao
玉掌献寿	yu'zhang'xian'shou
玉板蟹	yu'ban'xie
玉林茶泡	yu'lin'cha'pao
玉树麒麟生鱼	yu'shu'qi'lin'sheng'yu
玉桂叶	yu'gui'ye
玉桂粉肉桂粉	yu'gui'fen'rou'gui'fen
玉液泉	yu'ye'quan
玉溪水晶蜜饯	yu'xi'shui'jing'mi'jian
玉竹心子	yu'zhu'xin'zi
玉竹沙参鹧鸪汤	yu'zhu'sha'shen'zhe'gu'tang
玉竹炖鹧鸪	yu'zhu'dun'zhe'gu
玉竹猪心	yu'zhu'zhu'xin
玉竹百合猪瘦肉汤	yu'zhu'bai'he'zhu'shou'rou'tang
玉簪里脊	yu'zan'li'ji
玉米发糕	yu'mi'fa'gao
玉米汁饮料	yu'mi'zhi'yin'liao
玉米汤	yu'mi'tang
玉米淀粉糕点	yu'mi'dian'fen'gao'dian
玉米热狗	yu'mi're'gou
玉米粒罐头	yu'mi'li'guan'tou
玉米色拉	yu'mi'se'la
玉米须猪小肚汤	yu'mi'xu'zhu'xiao'du'tang
玉米须蜂蜜粥	yu'mi'xu'feng'mi'zhou
玉米须黑豆猪肉汤	yu'mi'xu'hei'dou'zhu'rou'tang
玉米饼	yu'mi'bing
玉米黄	yu'mi'huang
玉蕊茶	yu'rui'cha
玉馅酥	yu'xian'su
王婆麻辣鸡	wang'po'ma'la'ji
王星记扇子	wang'xing'ji'shan'zi
王老吉凉茶	wang'lao'ji'liang'cha
玛瑙银杏	ma'nao'yin'xing
玟瑰大虾	wen'gui'da'xia
玫瑰冰雪酥	mei'gui'bing'xue'su
玫瑰猪油松子枣泥麻饼	mei'gui'zhu'you'song'zi'zao'ni'ma'bing
玫瑰百果蜜糕	mei'gui'bai'guo'mi'gao
玫瑰米凉虾	mei'gui'mi'liang'xia
玫瑰糖	mei'gui'tang
玫瑰花粥	mei'gui'hua'zhou
玫瑰茄红	mei'gui'qie'hong
玫瑰茉莉绿茶	mei'gui'mo'li'lv'cha
玫瑰薄荷茶	mei'gui'bo'he'cha
玫瑰豆沙月饼	mei'gui'dou'sha'yue'bing
玫瑰酥	mei'gui'su
玫瑰锅炸	mei'gui'guo'zha
玫瑰露排骨	mei'gui'lu'pai'gu
玫瑰露酒	mei'gui'lu'jiu
玫瑰饼	mei'gui'bing
玫瑰魅力	mei'gui'mei'li
玫瑰凉糕	mei'gui'liang'gao
环宇牌	huan'yu'pai
环己基丙酸烯丙酯	huan'ji'ji'bing'suan'xi'bing'zhi
环己基氨基磺酸钙	huan'ji'ji'an'ji'huang'suan'gai
环己基氨基磺酸钠	huan'ji'ji'an'ji'huang'suan'na
环状糊精	huan'zhuang'hu'jing
玻璃明虾	bo'li'ming'xia
玻璃蛋糕	bo'li'dan'gao
玻璃酥鸡	bo'li'su'ji
玻璃鱿鱼	bo'li'you'yu
玻璃鲜墨	bo'li'xian'mo
珊瑚桂鱼	shan'hu'gui'yu
珊瑚花枝片	shan'hu'hua'zhi'pian
珊瑚金钩	shan'hu'jin'gou
珊瑚雪花鸡	shan'hu'xue'hua'ji
珊瑚鱼丁	shan'hu'yu'ding
珍珠元子	zhen'zhu'yuan'zi
珍珠南瓜	zhen'zhu'nan'gua
珍珠可乐	zhen'zhu'ke'le
珍珠圆子	zhen'zhu'yuan'zi
珍珠海参	zhen'zhu'hai'shen
珍珠豆腐羹	zhen'zhu'dou'fu'geng
珍珠豆腐	zhen'zhu'dou'fu
珍珠雪耳	zhen'zhu'xue'er
珍珠鲤鱼	zhen'zhu'li'yu
珍酥糕	zhen'su'gao
珍露	zhen'lu
珠兰花茶	zhu'lan'hua'cha
珠山茶	zhu'shan'cha
珠江啤酒	zhu'jiang'pi'jiu
班戟	ban'ji
琅源松萝茶	lang'yuan'song'luo'cha
琅琊酥糖	lang'ya'su'tang
琉璃珠玑	liu'li'zhu'ji
琉璃藕	liu'li'ou
琥珀酸二钠	hu'po'suan'er'na
琥珀酸单甘油酯	hu'po'suan'dan'gan'you'zhi
琥珀鸽蛋	hu'po'ge'dan
琳村花茶	lin'cun'hua'cha
琴火咖啡	qin'huo'ka'fei
琵琶大虾	pi'pa'da'xia
琵琶酥	pi'pa'su
琵琶鱼肚	pi'pa'yu'du
琼脂	qiong'zhi
瑞士冰咖啡	rui'shi'bing'ka'fei
瑞士卷	rui'shi'juan
瑞士咖啡人	rui'shi'ka'fei'ren
瑞士排骨	rui'shi'pai'gu
瑞士果仁饼	rui'shi'guo'ren'bing
瑞士黑森林蛋糕	rui'shi'hei'sen'lin'dan'gao
瓜仁枣泥派	gua'ren'zao'ni'pai
瓜尔胶	gua'er'jiao
瓜萎	gua'wei
瓜酒	gua'jiu
瓤甜椒	rang'tian'jiao
瓤豆腐	rang'dou'fu
瓦斯特克咖啡	wa'si'te'ke'ka'fei
瓦那蛋糕	wa'na'dan'gao
瓶装金针菇	ping'zhuang'jin'zhen'gu
甑山银毫	zeng'shan'yin'hao
甑糕	zeng'gao
甘柠芝麻虾	gan'ning'zhi'ma'xia
甘椒粉	gan'jiao'fen
甘氨酸锌	gan'an'suan'xin
甘氨酸	gan'an'suan
甘油脂肪酸酯	gan'you'zhi'fang'suan'zhi
甘牛至叶	gan'niu'zhi'ye
甘甜黑巧克力	gan'tian'hei'qiao'ke'li
甘笋甜糕	gan'sun'tian'gao
甘草抗氧化物	gan'cao'kang'yang'hua'wu
甘草酸一钾	gan'cao'suan'yi'jia
甘草酸三钾	gan'cao'suan'san'jia
甘草酸铵	gan'cao'suan'an
甘菊猪肚	gan'ju'zhu'du
甘蓝什锦串	gan'lan'shi'jin'chuan
甘露糖醇	gan'lu'tang'chun
甘露酥	gan'lu'su
甘露饼	gan'lu'bing
甘青宁新藏五省区	gan'qing'ning'xin'zang'wu'sheng'qu
甘麦红枣汤	gan'mai'hong'zao'tang
甘麦红枣粥	gan'mai'hong'zao'zhou
甜叶菊	tian'ye'ju
甜味剂	tian'wei'ji
甜奶油	tian'nai'you
甜曼哈顿	tian'man'ha'dun
甜椒南瓜汤	tian'jiao'nan'gua'tang
甜椒肉丝	tian'jiao'rou'si
甜橙油	tian'cheng'you
甜烧白	tian'shao'bai
甜玉米罐头	tian'yu'mi'guan'tou
甜玉米饮料	tian'yu'mi'yin'liao
甜瓜	tian'gua
甜甜圈	tian'tian'quan
甜盘子	tian'pan'zi
甜艾团	tian'ai'tuan
甜茶	tian'cha
甜菊糖苷	tian'ju'tang'gan
甜菊糖	tian'ju'tang
甜菊绿茶	tian'ju'lv'cha
甜菜红	tian'cai'hong
甜蒲桃	tian'pu'tao
甜藕粥	tian'ou'zhou
甜蜜素	tian'mi'su
甜蜜蜜果酱布丁	tian'mi'mi'guo'jiang'bu'ding
甜辣回锅肉	tian'la'hui'guo'rou
甜酒	tian'jiu
甜酸海蜇	tian'suan'hai'zhe
生命知已	sheng'ming'zhi'yi
生地排骨汤	sheng'di'pai'gu'tang
生姜粉	sheng'jiang'fen
生姜羊肉汤	sheng'jiang'yang'rou'tang
生态咖啡调糖	sheng'tai'ka'fei'tiao'tang
生敲膳丝	sheng'qiao'shan'si
生汆丸子	sheng'cuan'wan'zi
生炊麒麟鱼	sheng'chui'qi'lin'yu
生炊龙虾	sheng'chui'long'xia
生炒海蚌	sheng'chao'hai'bang
生炒蒜苔肉	sheng'chao'suan'tai'rou
生烧筋尾舌	sheng'shao'jin'wei'she
生煎包	sheng'jian'bao
生熏大黄鱼	sheng'xun'da'huang'yu
生爆盐煎肉	sheng'bao'yan'jian'rou
生牛肉和粉	sheng'niu'rou'he'fen
生牛肉河粉	sheng'niu'rou'he'fen
生物碳酸钙	sheng'wu'tan'suan'gai
生肖蛋糕	sheng'xiao'dan'gao
生鱼丝薄饼	sheng'yu'si'bao'bing
生鱼葛菜汤	sheng'yu'ge'cai'tang
甩饼	shuai'bing
田园果汁	tian'yuan'guo'zhi
田园汤	tian'yuan'tang
田园蘑菇沙拉	tian'yuan'mo'gu'sha'la
田纳西黑泥	tian'na'xi'hei'ni
田菁胶	tian'jing'jiao
田鸡油软糖	tian'ji'you'ruan'tang
甲基丁酸	jia'ji'ding'suan
甲基丁香酚	jia'ji'ding'xiang'fen
甲基乙酸乙酯	jia'ji'yi'suan'yi'zhi
甲基己醛	jia'ji'ji'quan
甲基环戊烯醇酮	jia'ji'huan'wu'xi'chun'tong
甲基苯乙酮	jia'ji'ben'yi'tong
甲基邻氨基苯甲酸甲酯	jia'ji'lin'an'ji'ben'jia'suan'jia'zhi
甲基香豆素	jia'ji'xiang'dou'su
甲壳素	jia'qiao'su
甲白皮	jia'bai'pi
甲酸松油酯	jia'suan'song'you'zhi
电解质饮料	dian'jie'zhi'yin'liao
电饭锅盐焗手撕鸡	dian'fan'guo'yan'ju'shou'si'ji
留兰香油	liu'lan'xiang'you
番石榴	fan'shi'liu
番茄拌豆腐	fan'qie'ban'dou'fu
番茄松鼠鱼	fan'qie'song'shu'yu
番茄沙司罐装	fan'qie'sha'si'guan'zhuang
番茄泡蛋汤	fan'qie'pao'dan'tang
番茄海蜇	fan'qie'hai'zhe
番茄炒西兰花	fan'qie'chao'xi'lan'hua
番茄炒豆腐	fan'qie'chao'dou'fu
番茄煮红衫鱼	fan'qie'zhu'hong'shan'yu
番茄牛肉羹	fan'qie'niu'rou'geng
番茄肉松三文治	fan'qie'rou'song'san'wen'zhi
番茄腰柳	fan'qie'yao'liu
番茄薯仔牛尾汤	fan'qie'shu'zai'niu'wei'tang
番茄蛋花汤	fan'qie'dan'hua'tang
番茄豆腐	fan'qie'dou'fu
番茄酱	fan'qie'jiang
番茄鱼片	fan'qie'yu'pian
番茄鸡蛋	fan'qie'ji'dan
番荔枝	fan'li'zhi
疗效水果罐头	liao'xiao'shui'guo'guan'tou
疗效糖果	liao'xiao'tang'guo
疗效饮料桔红露	liao'xiao'yin'liao'ju'hong'lu
疳积糕	gan'ji'gao
瘦肉汁炖虫草	shou'rou'zhi'dun'chong'cao
癸酸乙酯	gui'suan'yi'zhi
白丸子	bai'wan'zi
白云猪手	bai'yun'zhu'shou
白俄罗斯鸡尾酒	bai'e'luo'si'ji'wei'jiu
白兰地酒	bai'lan'di'jiu
白刀子	bai'dao'zi
白切鸡	bai'qie'ji
白切	bai'qie
白吉馍	bai'ji'mo
白啤酒	bai'pi'jiu
白圆蛋糕	bai'yuan'dan'gao
白天使蛋糕	bai'tian'shi'dan'gao
白宫城	bai'gong'cheng
白巧克力冰淇淋	bai'qiao'ke'li'bing'qi'lin
白干煮三丝	bai'gan'zhu'san'si
白扒鱼翅	bai'ba'yu'chi
白扒鲍鱼	bai'ba'bao'yu
白斩鸡	bai'zhan'ji
白月饼	bai'yue'bing
白术健脾粥	bai'zhu'jian'pi'zhou
白术猪肚汤	bai'zhu'zhu'du'tang
白果南杏生鱼汤	bai'guo'nan'xing'sheng'yu'tang
白果桂花羹	bai'guo'gui'hua'geng
白果海鲜羹	bai'guo'hai'xian'geng
白果烧鸡	bai'guo'shao'ji
白果苦瓜	bai'guo'ku'gua
白果鸭煲	bai'guo'ya'bao
白果	bai'guo
白橙糖	bai'cheng'tang
白水羊头	bai'shui'yang'tou
白汁五柳鱼	bai'zhi'wu'liu'yu
白汁全鱼	bai'zhi'quan'yu
白汁牛肉	bai'zhi'niu'rou
白汁玉翅	bai'zhi'yu'chi
白汁菜心	bai'zhi'cai'xin
白汁鱼肚	bai'zhi'yu'du
白汁鲳鱼	bai'zhi'chang'yu
白汁鳜鱼	bai'zhi'gui'yu
白沙井水煮白扎肉	bai'sha'jing'shui'zhu'bai'zha'rou
白沙液酒	bai'sha'ye'jiu
白油桃酥	bai'you'tao'su
白油肉片	bai'you'rou'pian
白油肝片	bai'you'gan'pian
白油豆腐	bai'you'dou'fu
白油	bai'you
白浇鳙鱼头	bai'jiao'yong'yu'tou
白灵菇罐头	bai'ling'gu'guan'tou
白灵菇	bai'ling'gu
白灼响螺片	bai'zhuo'xiang'luo'pian
白灼虾	bai'zhuo'xia
白灼	bai'zhuo
白炒三七花田鸡	bai'chao'san'qi'hua'tian'ji
白炒刀鱼丝	bai'chao'dao'yu'si
白炒虾球	bai'chao'xia'qiu
白烧鱼翅	bai'shao'yu'chi
白焯响螺	bai'chao'xiang'luo
白煮肉	bai'zhu'rou
白玉冰皮糕	bai'yu'bing'pi'gao
白玉翡翠	bai'yu'fei'cui
白皮枣泥饼	bai'pi'zao'ni'bing
白皮酥	bai'pi'su
白米酥	bai'mi'su
白糖云片糕	bai'tang'yun'pian'gao
白糖嫩酵糕	bai'tang'nen'jiao'gao
白羊肾羹	bai'yang'shen'geng
白肉	bai'rou
白肘子	bai'zhou'zi
白肚	bai'du
白肺汤	bai'fei'tang
白胡椒粉	bai'hu'jiao'fen
白胡椒	bai'hu'jiao
白色桑格利亚	bai'se'sang'ge'li'ya
白色西米	bai'se'xi'mi
白芦笋罐头	bai'lu'sun'guan'tou
白芨冰糖燕窝	bai'ji'bing'tang'yan'wo
白芨蒸银耳	bai'ji'zheng'yin'er
白芷当归鲤鱼汤	bai'zhi'dang'gui'li'yu'tang
白芷汤	bai'zhi'tang
白茅根蛤蜊	bai'mao'gen'ge'li
白茶	bai'cha
白菜木须	bai'cai'mu'xu
白菜萝卜鱼	bai'cai'luo'bo'yu
白菜锅子	bai'cai'guo'zi
白萝卜苹果汁	bai'luo'bo'ping'guo'zhi
白葡萄酒	bai'pu'tao'jiu
白虾干	bai'xia'gan
白蜂糕	bai'feng'gao
白蜜食	bai'mi'shi
白蜜黄螺	bai'mi'huang'luo
白豆	bai'dou
白豪银针茶	bai'hao'yin'zhen'cha
白醋鸡蛋	bai'cu'ji'dan
白银如意	bai'yin'ru'yi
白鲞扣鸡	bai'xiang'kou'ji
百事可乐	bai'shi'ke'le
百仁全鸭	bai'ren'quan'ya
百利甜酒慕斯蛋糕	bai'li'tian'jiu'mu'si'dan'gao
百利黑樱桃罐头	bai'li'hei'ying'tao'guan'tou
百叶酥	bai'ye'su
百合冰咖啡	bai'he'bing'ka'fei
百合地黄粥	bai'he'di'huang'zhou
百合枣仁汤	bai'he'zao'ren'tang
百合灵芝	bai'he'ling'zhi
百合炒西兰花	bai'he'chao'xi'lan'hua
百合熘鸡片	bai'he'liu'ji'pian
百合牛肉	bai'he'niu'rou
百合糕	bai'he'gao
百合罐头	bai'he'guan'tou
百合莲子浆	bai'he'lian'zi'jiang
百合酥	bai'he'su
百合银耳罗汉果汤	bai'he'yin'er'luo'han'guo'tang
百合陈皮鲫鱼汤	bai'he'chen'pi'ji'yu'tang
百子冬瓜	bai'zi'dong'gua
百子寿桃	bai'zi'shou'tao
百寿桃	bai'shou'tao
百折酥糖	bai'zhe'su'tang
百果佳	bai'guo'jia
百果年糕	bai'guo'nian'gao
百果提浆饼	bai'guo'ti'jiang'bing
百果糕	bai'guo'gao
百美佳	bai'mei'jia
百花大虾	bai'hua'da'xia
百花糕	bai'hua'gao
百花辽参	bai'hua'liao'can
百花鸡	bai'hua'ji
百草梨膏糖	bai'cao'li'gao'tang
百草霜鸡蛋	bai'cao'shuang'ji'dan
百里香叶	bai'li'xiang'ye
百里香粉	bai'li'xiang'fen
百里香	bai'li'xiang
百香果	bai'xiang'guo
百鸟朝凤	bai'niao'chao'feng
皂荚糖胶	zao'jia'tang'jiao
皇宫牛肉软罐头	huang'gong'niu'rou'ruan'guan'tou
皇家咖啡	huang'jia'ka'fei
皇岭	huang'ling
皇盾	huang'dun
皇禽酱鸭	huang'qin'jiang'ya
皖古王	wan'gu'wang
皖西黄大茶	wan'xi'huang'da'cha
皮条鳝鱼	pi'tiao'shan'yu
皮片乳猪	pi'pian'ru'zhu
皮萨草叶	pi'sa'cao'ye
皮蛋烩排骨	pi'dan'hui'pai'gu
皮蛋糕	pi'dan'gao
皮蛋肠	pi'dan'chang
皮蛋酥	pi'dan'su
益力多	yi'li'duo
益力宝	yi'li'bao
益母羊肉汤	yi'mu'yang'rou'tang
益母草炖鸡	yi'mu'cao'dun'ji
益胃汤	yi'wei'tang
益都	yi'du
盐步秋茄	yan'bu'qiu'qie
盐水肘花儿	yan'shui'zhou'hua'er
盐水肫花	yan'shui'zhun'hua
盐水胡萝卜罐头	yan'shui'hu'luo'bo'guan'tou
盐水蕨菜罐头	yan'shui'jue'cai'guan'tou
盐水鸭亲	yan'shui'ya'qin
盐水鸭	yan'shui'ya
盐渍姬菇罐头	yan'zi'ji'gu'guan'tou
盐煎肉	yan'jian'rou
盐菜回锅肉	yan'cai'hui'guo'rou
盐蛋	yan'dan
盐酸硫胺素	yan'suan'liu'an'su
盐酸菜烧鱼	yan'suan'cai'shao'yu
盐酸	yan'suan
盐饼子	yan'bing'zi
盐饼	yan'bing
盘古神鹿	pan'gu'shen'lu
盛百威包装	sheng'bai'wei'bao'zhuang
盛记	sheng'ji
盲公饼	mang'gong'bing
直港大道	zhi'gang'da'dao
眉毛酥	mei'mao'su
真味珍	zhen'wei'zhen
真豆咖啡	zhen'dou'ka'fei
眼肉	yan'rou
眼镜面	yan'jing'mian
着色剂	zhuo'se'ji
瞻埠潭	zhan'bu'tan
石亭绿茶	shi'ting'lv'cha
石子馍	shi'zi'mo
石家酱方	shi'jia'jiang'fang
石屏荔枝酥	shi'ping'li'zhi'su
石岐乳鸽	shi'qi'ru'ge
石斑鱼	shi'ban'yu
石斛花生米	shi'hu'hua'sheng'mi
石榴包	shi'liu'bao
石榴鸡	shi'liu'ji
石狮甜果	shi'shi'tian'guo
石磨豆花	shi'mo'dou'hua
石竹茶	shi'zhu'cha
石耳炖鸡	shi'er'dun'ji
石膏	shi'gao
石花菜鲍鱼汤	shi'hua'cai'bao'yu'tang
石蜡	shi'la
石门空心茶	shi'men'kong'xin'cha
矿泉水冷面	kuang'quan'shui'leng'mian
砀山梨	dang'shan'li
砂仁糕	sha'ren'gao
砂仁羊肉汤	sha'ren'yang'rou'tang
砂煲鱼头	sha'bao'yu'tou
砂窝鱼头豆腐	sha'wo'yu'tou'dou'fu
砂锅三味	sha'guo'san'wei
砂锅山海	sha'guo'shan'hai
砂锅菜核	sha'guo'cai'he
砂锅螃蟹	sha'guo'pang'xie
砂锅雅鱼	sha'guo'ya'yu
砂锅鱼	sha'guo'yu
砂锅鱿鱼	sha'guo'you'yu
砂锅鸭块	sha'guo'ya'kuai
砍盆箐茶	kan'pen'jing'cha
砍花糖	kan'hua'tang
砣砣鸡肉	tuo'tuo'ji'rou
破酥包子	po'su'bao'zi
破酥包	po'su'bao
破酥缸炉	po'su'gang'lu
硅酸钙	gui'suan'gai
硅酸铝	gui'suan'lv
硅铝酸钙	gui'lv'suan'gai
硅铝酸钠	gui'lv'suan'na
硒化卡拉胶	xi'hua'ka'la'jiao
硝酸硫胺素	xiao'suan'liu'an'su
硝酸钠硝酸钾	xiao'suan'na'xiao'suan'jia
硝酸钠	xiao'suan'na
硫代二丙酸二月桂酯	liu'dai'er'bing'suan'er'yue'gui'zhi
硫代二丙酸二月桂	liu'dai'er'bing'suan'er'yue'gui
硫磺	liu'huang
硫酸亚铁	liu'suan'ya'tie
硫酸钙	liu'suan'gai
硫酸铜	liu'suan'tong
硫酸铝钾	liu'suan'lv'jia
硫酸铝铵	liu'suan'lv'an
硫酸锌	liu'suan'xin
硫酸锰	liu'suan'meng
硬壳火腿饼	ying'qiao'huo'tui'bing
硬脂酰乳酸钙	ying'zhi'xian'ru'suan'gai
硬脂酰乳酸钠	ying'zhi'xian'ru'suan'na
硬脂酸钙	ying'zhi'suan'gai
硬脂酸钾	ying'zhi'suan'jia
硬脂酸镁	ying'zhi'suan'mei
硬脂酸	ying'zhi'suan
硬蛋糕	ying'dan'gao
碎末鸡丁	sui'mo'ji'ding
碎米鸡丁	sui'mi'ji'ding
碣滩茶	jie'tan'cha
碧波田鸡	bi'bo'tian'ji
碧海银沙	bi'hai'yin'sha
碧绿虾仁	bi'lv'xia'ren
碧螺春	bi'luo'chun
碱酥饼	jian'su'bing
碳烧啤酒	tan'shao'pi'jiu
碳酸氢三钠	tan'suan'qing'san'na
碳酸氢钠	tan'suan'qing'na
碳酸氢钾	tan'suan'qing'jia
碳酸氢铵	tan'suan'qing'an
碳酸钙	tan'suan'gai
碳酸钠	tan'suan'na
碳酸钾	tan'suan'jia
碳酸镁	tan'suan'mei
磷脂酰乙醇胺	lin'zhi'xian'yi'chun'an
磷脂酶	lin'zhi'mei
磷脂	lin'zhi
磷酸三钙	lin'suan'san'gai
磷酸三钠	lin'suan'san'na
磷酸三钾	lin'suan'san'jia
磷酸二氢钙	lin'suan'er'qing'gai
磷酸二氢钠	lin'suan'er'qing'na
磷酸二氢钾	lin'suan'er'qing'jia
磷酸化二淀粉磷酸酯	lin'suan'hua'er'dian'fen'lin'suan'zhi
磷酸氢二钠	lin'suan'qing'er'na
磷酸氢二钾	lin'suan'qing'er'jia
磷酸氢钙	lin'suan'qing'gai
磷酸镁	lin'suan'mei
磷酸	lin'suan
礼饼	li'bing
祁红茶	qi'hong'cha
祖庵鱼翅	zu'an'yu'chi
祛湿通淋糖水	qu'shi'tong'lin'tang'shui
神仙鸭子	shen'xian'ya'zi
神农牌	shen'nong'pai
神秘果	shen'mi'guo
福寿临门	fu'shou'lin'men
福山烧小鸡	fu'shan'shao'xiao'ji
福州茉莉花茶	fu'zhou'mo'li'hua'cha
福州龙须长春燕	fu'zhou'long'xu'chang'chun'yan
福建省	fu'jian'sheng
福建菜	fu'jian'cai
福鼎莲芯茶白毫银针茶	fu'ding'lian'xin'cha'bai'hao'yin'zhen'cha
禹城扒鸡	yu'cheng'pa'ji
秀兰邓波尔	xiu'lan'deng'bo'er
秀山雪枣	xiu'shan'xue'zao
私房黄油曲奇饼干	si'fang'huang'you'qu'qi'bing'gan
秋梨膏的做法	qiu'li'gao'de'zuo'fa
秋禾	qiu'he
秋菊傲霜	qiu'ju'ao'shuang
科劳	ke'lao
科斯塔	ke'si'ta
科露蕰堡	ke'lu'wen'bao
科飞	ke'fei
秘制国药中华鳖	mi'zhi'guo'yao'zhong'hua'bie
秘制豉香排	mi'zhi'chi'xiang'pai
秘制鸳鸯鸡	mi'zhi'yuan'yang'ji
秦妈	qin'ma
秦川牌	qin'chuan'pai
秦镇凉皮	qin'zhen'liang'pi
秦镇米皮	qin'zhen'mi'pi
稳定剂	wen'ding'ji
稳定态二氧化氯	wen'ding'tai'er'yang'hua'lv
稻花香	dao'hua'xiang
稻谷	dao'gu
稻香春南味食品	dao'xiang'chun'nan'wei'shi'pin
空心南瓜饼	kong'xin'nan'gua'bing
空心果	kong'xin'guo
空心琉璃丸子	kong'xin'liu'li'wan'zi
空心魁面	kong'xin'kui'mian
空心鱼丸汤	kong'xin'yu'wan'tang
窝丝糖	wo'si'tang
竹叶抗氧化物	zhu'ye'kang'yang'hua'wu
竹叶青露	zhu'ye'qing'lu
竹桶粽子	zhu'tong'zong'zi
竹沥姜汁粥	zhu'li'jiang'zhi'zhou
竹福天然竹汁	zhu'fu'tian'ran'zhu'zhi
竹笋芋艿鲫鱼汤	zhu'sun'yu'nai'ji'yu'tang
竹笋西瓜皮鲤鱼汤	zhu'sun'xi'gua'pi'li'yu'tang
竹笋香菇汤	zhu'sun'xiang'gu'tang
竹笙鸳鸯卷	zhu'sheng'yuan'yang'juan
竹筒仔鸡	zhu'tong'zi'ji
竹筒茶	zhu'tong'cha
竹筒饭	zhu'tong'fan
竹节虾	zhu'jie'xia
竹节鸡盅	zhu'jie'ji'zhong
竹荪	zhu'sun
竹蔗红萝卜猪骨汤	zhu'zhe'hong'luo'bo'zhu'gu'tang
竹蔗芫荽汤	zhu'zhe'yan'sui'tang
竹蔗茅根精	zhu'zhe'mao'gen'jing
笋丝百叶	sun'si'bai'ye
笋烧海参	sun'shao'hai'shen
笋鲍鱼汤	sun'bao'yu'tang
符离鸡罐头	fu'li'ji'guan'tou
筒子鸡	tong'zi'ji
简易蓝莓布丁	jian'yi'lan'mei'bu'ding
简易蛋糕	jian'yi'dan'gao
箩粉鱼头豆腐汤	luo'fen'yu'tou'dou'fu'tang
篮球鸽蛋	lan'qiu'ge'dan
米仁	mi'ren
米冻	mi'dong
米凉粉	mi'liang'fen
米凉虾	mi'liang'xia
米椒羊杂	mi'jiao'yang'za
米皮	mi'pi
米粉肉	mi'fen'rou
米粉蒸肉	mi'fen'zheng'rou
米糕	mi'gao
米糖	mi'tang
米线	mi'xian
米老鼠蛋糕	mi'lao'shu'dan'gao
米花茶	mi'hua'cha
米苋黄鱼羹	mi'xian'huang'yu'geng
米茸芋丝虾煲	mi'rong'yu'si'xia'bao
米酒茶香鸭	mi'jiu'cha'xiang'ya
粉丝焗膏蟹	fen'si'ju'gao'xie
粉丝香菇蛋汤	fen'si'xiang'gu'dan'tang
粉汤羊血	fen'tang'yang'xue
粉皮白肉	fen'pi'bai'rou
粉皮辣鱼	fen'pi'la'yu
粉皮	fen'pi
粉蒸排骨	fen'zheng'pai'gu
粉蒸牛羊肉	fen'zheng'niu'yang'rou
粉蒸牛肉	fen'zheng'niu'rou
粉蒸羊肉	fen'zheng'yang'rou
粉蒸肉	fen'zheng'rou
粉蒸鳜鱼	fen'zheng'gui'yu
粑粑卷	ba'ba'juan
粗花糕	cu'hua'gao
粗黑胡椒粉	cu'hei'hu'jiao'fen
粘玉米蒸糕	zhan'yu'mi'zheng'gao
粘花饼干	zhan'hua'bing'gan
粟米粥	su'mi'zhou
粟米菜花汤	su'mi'cai'hua'tang
粟米葫芦排骨汤	su'mi'hu'lu'pai'gu'tang
粟米香菇排骨汤	su'mi'xiang'gu'pai'gu'tang
粤菜	yue'cai
粽子糖	zong'zi'tang
精气神山黑猪清蒸肉罐头	jing'qi'shen'shan'hei'zhu'qing'zheng'rou'guan'tou
糊塌子	hu'ta'zi
糊涂鸡	hu'tu'ji
糖化酶制剂	tang'hua'mei'zhi'ji
糖卷果	tang'juan'guo
糖心蛋	tang'xin'dan
糖拌菜心	tang'ban'cai'xin
糖桂花	tang'gui'hua
糖水杏罐头	tang'shui'xing'guan'tou
糖水洋梨罐头	tang'shui'yang'li'guan'tou
糖水甜杏罐头	tang'shui'tian'xing'guan'tou
糖水红薯圆子	tang'shui'hong'shu'yuan'zi
糖水荔枝罐头	tang'shui'li'zhi'guan'tou
糖水葡萄罐头	tang'shui'pu'tao'guan'tou
糖水黄桃罐头	tang'shui'huang'tao'guan'tou
糖水	tang'shui
糖浆	tang'jiang
糖火烧	tang'huo'shao
糖炒栗子	tang'chao'li'zi
糖炒红薯泥	tang'chao'hong'shu'ni
糖炒虾瓣	tang'chao'xia'ban
糖熘鲤鱼	tang'liu'li'yu
糖米花和糯米饼	tang'mi'hua'he'nuo'mi'bing
糖粉软糯粑	tang'fen'ruan'nuo'ba
糖粉	tang'fen
糖精钠	tang'jing'na
糖耳朵	tang'er'duo
糖胶树胶	tang'jiao'shu'jiao
糖腿包子	tang'tui'bao'zi
糖腿包	tang'tui'bao
糖腿破酥包子	tang'tui'po'su'bao'zi
糖舌饼	tang'she'bing
糖花蛋糕	tang'hua'dan'gao
糖衣炮弹	tang'yi'pao'dan
糖酥煎饼	tang'su'jian'bing
糖酱鱼	tang'jiang'yu
糖醋咕噜肉	tang'cu'gu'lu'rou
糖醋嫩藕	tang'cu'nen'ou
糖醋小排	tang'cu'xiao'pai
糖醋小萝卜	tang'cu'xiao'luo'bo
糖醋带鱼	tang'cu'dai'yu
糖醋排骨	tang'cu'pai'gu
糖醋泡菜	tang'cu'pao'cai
糖醋猪腰	tang'cu'zhu'yao
糖醋瓦块鱼	tang'cu'wa'kuai'yu
糖醋瓦罐鱼	tang'cu'wa'guan'yu
糖醋素排骨	tang'cu'su'pai'gu
糖醋红柿椒	tang'cu'hong'shi'jiao
糖醋荷藕	tang'cu'he'ou
糖醋莴笋	tang'cu'wo'sun
糖醋藕块	tang'cu'ou'kuai
糖醋蜜肉	tang'cu'mi'rou
糖醋软熘鲤鱼焙面	tang'cu'ruan'liu'li'yu'bei'mian
糖醋软熘黄河鲤鱼	tang'cu'ruan'liu'huang'he'li'yu
糖醋里脊	tang'cu'li'ji
糖醋面筋	tang'cu'mian'jin
糖醋鱼卷	tang'cu'yu'juan
糖醋鱼条	tang'cu'yu'tiao
糖醋鲜藕	tang'cu'xian'ou
糖醋鲤鱼	tang'cu'li'yu
糖醋鸡圆	tang'cu'ji'yuan
糖醋鸡块	tang'cu'ji'kuai
糙米	cao'mi
糟油青鱼划水	zao'you'qing'yu'hua'shui
糟炒厚鱼片	zao'chao'hou'yu'pian
糟烩鞭笋	zao'hui'bian'sun
糟煨冬笋	zao'wei'dong'sun
糟熘鱼片	zao'liu'yu'pian
糟辣脆皮鱼	zao'la'cui'pi'yu
糟鸭	zao'ya
糯米八宝饭	nuo'mi'ba'bao'fan
糯米内金粥	nuo'mi'nei'jin'zhou
糯米凉糕	nuo'mi'liang'gao
糯米团	nuo'mi'tuan
糯米大枣粥	nuo'mi'da'zao'zhou
糯米油稣鸡	nuo'mi'you'su'ji
糯米球	nuo'mi'qiu
糯米砣	nuo'mi'tuo
糯米粑粑	nuo'mi'ba'ba
糯米粥	nuo'mi'zhou
糯米糍	nuo'mi'ci
糯米糖藕	nuo'mi'tang'ou
糯米藕片	nuo'mi'ou'pian
糯米面蒸牛头糕	nuo'mi'mian'zheng'niu'tou'gao
糯米鸡肉卷	nuo'mi'ji'rou'juan
素火腿	su'huo'tui
素炒腐球	su'chao'fu'qiu
素炒茭白丝	su'chao'jiao'bai'si
素炒豇豆	su'chao'jiang'dou
素炒鸡丁	su'chao'ji'ding
素烧鹅	su'shao'e
素烩	su'hui
素脆鳝	su'cui'shan
素酿南瓜	su'niang'nan'gua
素锅烤鸭	su'guo'kao'ya
素锅盔	su'guo'kui
紫光液	zi'guang'ye
紫桂焖大排	zi'gui'men'da'pai
紫梅软糖和大虾糖	zi'mei'ruan'tang'he'da'xia'tang
紫甘蓝	zi'gan'lan
紫盖肉	zi'gai'rou
紫米九层糕	zi'mi'jiu'ceng'gao
紫米八宝饭	zi'mi'ba'bao'fan
紫米珍珠丸	zi'mi'zhen'zhu'wan
紫米	zi'mi
紫糯米八宝饭	zi'nuo'mi'ba'bao'fan
紫糯米	zi'nuo'mi
紫罗兰酮	zi'luo'lan'tong
紫背天葵	zi'bei'tian'kui
紫胶红	zi'jiao'hong
紫胶	zi'jiao
紫苋菜粥	zi'xian'cai'zhou
紫苏叶	zi'su'ye
紫苏梅鸡	zi'su'mei'ji
紫苏红枣汤	zi'su'hong'zao'tang
紫草红	zi'cao'hong
紫菜蛋皮卷	zi'cai'dan'pi'juan
紫菜	zi'cai
紫萝牛肉	zi'luo'niu'rou
紫薯冰皮月饼	zi'shu'bing'pi'yue'bing
紫薯慕斯	zi'shu'mu'si
红万寿	hong'wan'shou
红丸子	hong'wan'zi
红喜包	hong'xi'bao
红土地	hong'tu'di
红扒排翅	hong'ba'pai'chi
红扒鱼唇	hong'ba'yu'chun
红扒鱼翅	hong'ba'yu'chi
红扒鱼肚	hong'ba'yu'du
红曲米	hong'qu'mi
红曲红	hong'qu'hong
红杞活鱼	hong'qi'huo'yu
红杞蒸鸡	hong'qi'zheng'ji
红松宝	hong'song'bao
红松鳜鱼	hong'song'gui'yu
红果茶	hong'guo'cha
红果	hong'guo
红枣年糕	hong'zao'nian'gao
红枣枸杞奶	hong'zao'gou'qi'nai
红枣炖梨	hong'zao'dun'li
红枣炖肘	hong'zao'dun'zhou
红枣炖蚕蛹	hong'zao'dun'can'yong
红枣煨肘	hong'zao'wei'zhou
红枣煲泥鳅鱼汤	hong'zao'bao'ni'qiu'yu'tang
红枣红糖煮南瓜	hong'zao'hong'tang'zhu'nan'gua
红枣茯苓粥	hong'zao'fu'ling'zhou
红枣菊花粥	hong'zao'ju'hua'zhou
红枣薏仁粥	hong'zao'yi'ren'zhou
红枣酥肉	hong'zao'su'rou
红柿	hong'shi
红椒爆鲜虾	hong'jiao'bao'xian'xia
红椒酿肉	hong'jiao'niang'rou
红楼糕点	hong'lou'gao'dian
红橙	hong'cheng
红毛丹	hong'mao'dan
红汤年糕条	hong'tang'nian'gao'tiao
红油抄手酱	hong'you'chao'shou'jiang
红油抄手	hong'you'chao'shou
红油耳片	hong'you'er'pian
红油肚丝	hong'you'du'si
红油鸡块	hong'you'ji'kuai
红油	hong'you
红润辣得跳	hong'run'la'de'tiao
红烧下巴	hong'shao'xia'ba
红烧五花肉	hong'shao'wu'hua'rou
红烧全狗	hong'shao'quan'gou
红烧冬瓜	hong'shao'dong'gua
红烧划水	hong'shao'hua'shui
红烧卷筒鸡	hong'shao'juan'tong'ji
红烧卷鸡	hong'shao'juan'ji
红烧咕噜肉	hong'shao'gu'lu'rou
红烧大虾	hong'shao'da'xia
红烧栗子鸡	hong'shao'li'zi'ji
红烧浮皮	hong'shao'fu'pi
红烧海皇翅	hong'shao'hai'huang'chi
红烧火腩	hong'shao'huo'nan
红烧熊掌	hong'shao'xiong'zhang
红烧牛掌	hong'shao'niu'zhang
红烧牛肉罐头	hong'shao'niu'rou'guan'tou
红烧牛肉面	hong'shao'niu'rou'mian
红烧牛肉	hong'shao'niu'rou
红烧牛腩	hong'shao'niu'nan
红烧牛蒡肉捲	hong'shao'niu'bang'rou'juan
红烧狮子头	hong'shao'shi'zi'tou
红烧猪手	hong'shao'zhu'shou
红烧猪肚	hong'shao'zhu'du
红烧猪脑	hong'shao'zhu'nao
红烧猪腰	hong'shao'zhu'yao
红烧猪蹄子	hong'shao'zhu'ti'zi
红烧猪蹄	hong'shao'zhu'ti
红烧猴头蘑	hong'shao'hou'tou'mo
红烧腐竹	hong'shao'fu'zhu
红烧蹄筋	hong'shao'ti'jin
红烧野鸭	hong'shao'ye'ya
红烧鮰鱼	hong'shao'hui'yu
红烧鱼唇	hong'shao'yu'chun
红烧鱼骨	hong'shao'yu'gu
红烧鱼	hong'shao'yu
红烧鸭翅	hong'shao'ya'chi
红烧鹿筋	hong'shao'lu'jin
红焖娃娃鱼	hong'men'wa'wa'yu
红焖海参	hong'men'hai'shen
红焖肉	hong'men'rou
红焖麻雀	hong'men'ma'que
红甜菜罐头	hong'tian'cai'guan'tou
红白姜芽	hong'bai'jiang'ya
红碎茶	hong'sui'cha
红米红	hong'mi'hong
红糖果仁饼干	hong'tang'guo'ren'bing'gan
红糖米花糖	hong'tang'mi'hua'tang
红糟片鸭	hong'zao'pian'ya
红糟鱼丝	hong'zao'yu'si
红绿羊羹	hong'lv'yang'geng
红肘子	hong'zhou'zi
红花鸡肝饼	hong'hua'ji'gan'bing
红花黄	hong'hua'huang
红芽歪尾桃	hong'ya'wai'wei'tao
红苕泥	hong'shao'ni
红苕米线	hong'shao'mi'xian
红苕饼	hong'shao'bing
红茶元宝	hong'cha'yuan'bao
红茶杏仁巧克力	hong'cha'xing'ren'qiao'ke'li
红茶松饼	hong'cha'song'bing
红茶海绵蛋糕	hong'cha'hai'mian'dan'gao
红茶猫舌饼	hong'cha'mao'she'bing
红茶甜甜圈	hong'cha'tian'tian'quan
红茶磅蛋糕	hong'cha'bang'dan'gao
红茶饼干	hong'cha'bing'gan
红菊牌萨琪玛	hong'ju'pai'sa'qi'ma
红萝卜排骨汤	hong'luo'bo'pai'gu'tang
红萬寿	hong'wan'shou
红葡萄酒	hong'pu'tao'jiu
红葱烧腊肉	hong'cong'shao'la'rou
红薯宽粉	hong'shu'kuan'fen
红薯粉丝	hong'shu'fen'si
红薯粉条	hong'shu'fen'tiao
红薯酸奶	hong'shu'suan'nai
红虾酥心糖	hong'xia'su'xin'tang
红蜻蜓鱼头火锅	hong'qing'ting'yu'tou'huo'guo
红衣财神系列	hong'yi'cai'shen'xi'lie
红袍油糕	hong'pao'you'gao
红袍莲子	hong'pao'lian'zi
红豆土司	hong'dou'tu'si
红豆甘薯糖水	hong'dou'gan'shu'tang'shui
红豆百合糖水	hong'dou'bai'he'tang'shui
红豆膳粥	hong'dou'shan'zhou
红豆芝士	hong'dou'zhi'shi
红豆莲枣粽	hong'dou'lian'zao'zong
红豆薏仁冻	hong'dou'yi'ren'dong
红豆蛋挞	hong'dou'dan'ta
红豆酱	hong'dou'jiang
红豆鲤鱼汤	hong'dou'li'yu'tang
红辣椒爆炒鳝片	hong'la'jiao'bao'chao'shan'pian
红酒牛腩	hong'jiu'niu'nan
红酒醋	hong'jiu'cu
红酥小鲫鱼	hong'su'xiao'ji'yu
红醋栗	hong'cu'li
红雪牌柠檬汽水	hong'xue'pai'ning'meng'qi'shui
红颜汤	hong'yan'tang
红魔鬼	hong'mo'gui
红鱼拜年	hong'yu'bai'nian
红鹰牌海底鸡	hong'ying'pai'hai'di'ji
纤扬茶	xian'yang'cha
纤维粗粮饼	xian'wei'cu'liang'bing
约什鸡尾酒	yue'shi'ji'wei'jiu
纯净水	chun'jing'shui
纯黑胡椒粉	chun'hei'hu'jiao'fen
纳溪泡糖	na'xi'pao'tang
纸包三鲜	zhi'bao'san'xian
纸包鸡	zhi'bao'ji
纸杯果仁玛芬	zhi'bei'guo'ren'ma'fen
纸杯蛋糕	zhi'bei'dan'gao
纽扣曲奇	niu'kou'qu'qi
纽约芝士蛋糕	niu'yue'zhi'shi'dan'gao
纽约重乳酪蛋糕	niu'yue'zhong'ru'lao'dan'gao
组庵鱼翅	zu'an'yu'chi
细沙绿豆糕	xi'sha'lv'dou'gao
细花糕	xi'hua'gao
细黑胡椒粉	xi'hei'hu'jiao'fen
绍子烘蛋	shao'zi'hong'dan
绞股蓝粥	jiao'gu'lan'zhou
统管糖	tong'guan'tang
绣球全鱼	xiu'qiu'quan'yu
绣球干贝	xiu'qiu'gan'bei
绣球薯圆	xiu'qiu'shu'yuan
绣球蛋糕	xiu'qiu'dan'gao
绣球鱼翅	xiu'qiu'yu'chi
绥阳空心面	sui'yang'kong'xin'mian
继光饼	ji'guang'bing
绩溪一品锅	ji'xi'yi'pin'guo
维也纳冰咖啡	wei'ye'na'bing'ka'fei
维也纳咖啡	wei'ye'na'ka'fei
维也纳巧克力杏仁蛋糕	wei'ye'na'qiao'ke'li'xing'ren'dan'gao
维力珍味肉燥罐	wei'li'zhen'wei'rou'zao'guan
维多利亚三明治	wei'duo'li'ya'san'ming'zhi
维多思果汁	wei'duo'si'guo'zhi
维尼熊可可蛋糕	wei'ni'xiong'ke'ke'dan'gao
维康舒粒粒枣	wei'kang'shu'li'li'zao
维生素	wei'sheng'su
绵竹桔片冻糖	mian'zhu'ju'pian'dong'tang
绿兰莎	lv'lan'sha
绿叶薄荷糖	lv'ye'bo'he'tang
绿园居	lv'yuan'ju
绿橙	lv'cheng
绿沁园	lv'qin'yuan
绿盛源	lv'sheng'yuan
绿窖王	lv'jiao'wang
绿芦笋罐头	lv'lu'sun'guan'tou
绿苹果	lv'ping'guo
绿茶冰淇淋慕斯	lv'cha'bing'qi'lin'mu'si
绿茶慕斯	lv'cha'mu'si
绿茶糕点	lv'cha'gao'dian
绿茶糯米卷	lv'cha'nuo'mi'juan
绿茶蛋糕	lv'cha'dan'gao
绿茶软糖	lv'cha'ruan'tang
绿茶酥	lv'cha'su
绿草牛	lv'cao'niu
绿菊鱼头汤	lv'ju'yu'tou'tang
绿豆乳饮料	lv'dou'ru'yin'liao
绿豆冬瓜汤	lv'dou'dong'gua'tang
绿豆凸	lv'dou'tu
绿豆沙果酱	lv'dou'sha'guo'jiang
绿豆沙酿香芋	lv'dou'sha'niang'xiang'yu
绿豆糕	lv'dou'gao
绿豆饼	lv'dou'bing
缎带抹茶慕斯蛋糕	duan'dai'mo'cha'mu'si'dan'gao
罐儿肉	guan'er'rou
罐儿野鸡	guan'er'ye'ji
罐儿鹌鹑	guan'er'an'chun
罐头梨	guan'tou'li
罐茶	guan'cha
网包鳜鱼	wang'bao'gui'yu
网油腰卷	wang'you'yao'juan
网油鱼包	wang'you'yu'bao
网清茶	wang'qing'cha
罗先尼	luo'xian'ni
罗勒叶	luo'le'ye
罗卜红	luo'bu'hong
罗宋汤	luo'song'tang
罗定鸡排	luo'ding'ji'pai
罗岗话梅	luo'gang'hua'mei
罗望子多糖胶	luo'wang'zi'duo'tang'jiao
罗汉大虾	luo'han'da'xia
罗汉果八珍汤	luo'han'guo'ba'zhen'tang
罗汉果冲剂	luo'han'guo'chong'ji
罗汉果焖瓜子鸡	luo'han'guo'men'gua'zi'ji
罗汉果西洋菜猪踭汤	luo'han'guo'xi'yang'cai'zhu'zheng'tang
罗汉果	luo'han'guo
罗汉饼	luo'han'bing
罗汉鸭	luo'han'ya
罗莎草莓汁	luo'sha'cao'mei'zhi
罗锅肉	luo'guo'rou
羊尾桃	yang'wei'tao
羊排	yang'pai
羊杂汤锅	yang'za'tang'guo
羊杂碎	yang'za'sui
羊柳	yang'liu
羊眼包子	yang'yan'bao'zi
羊耳鸡塔	yang'er'ji'ta
羊肉汤锅	yang'rou'tang'guo
羊肉泡馍	yang'rou'pao'mo
羊肉笼笼	yang'rou'long'long
羊肉粉	yang'rou'fen
美且有雪片	mei'qie'you'xue'pian
美乐多	mei'yue'duo
美人肝	mei'ren'gan
美原酥饺	mei'yuan'su'jiao
美味楞头鱼	mei'wei'leng'tou'yu
美国奥丽蓝梅淡糖浆罐头	mei'guo'ao'li'lan'mei'dan'tang'jiang'guan'tou
美国蛇果	mei'guo'she'guo
美国香瓜	mei'guo'xiang'gua
美极基围虾	mei'ji'ji'wei'xia
美柠露	mei'ning'lu
美津健康饮料	mei'jin'jian'kang'yin'liao
美滋乐	mei'zi'le
美白淡斑茶	mei'bai'dan'ban'cha
美的青春茶	mei'di'qing'chun'cha
美禄蛋糕	mei'lu'dan'gao
美禄	mei'lu
美露	mei'lu
羟丙基二淀粉磷酸酯	qiang'bing'ji'er'dian'fen'lin'suan'zhi
羟丙基淀粉醚	qiang'bing'ji'dian'fen'mi
羟丙基淀粉	qiang'bing'ji'dian'fen
羟基硬脂精	qiang'ji'ying'zhi'jing
羟基香茅醛	qiang'ji'xiang'mao'quan
羟甲基淀粉钠	qiang'jia'ji'dian'fen'na
羟钴胺素盐酸盐	qiang'gu'an'su'yan'suan'yan
羧甲基淀粉钠	suo'jia'ji'dian'fen'na
羧甲基纤维素钠	suo'jia'ji'xian'wei'su'na
翠云水煮鱼	cui'yun'shui'zhu'yu
翠亨邨	cui'heng'cun
翠坪银针茶	cui'ping'yin'zhen'cha
翠玉豆糕	cui'yu'dou'gao
翠珠鹿筋	cui'zhu'lu'jin
翠竹粉蒸鮰鱼	cui'zhu'fen'zheng'hui'yu
翠竹粉蒸鱼	cui'zhu'fen'zheng'yu
翠绿玉米	cui'lv'yu'mi
翡翠干贝冬茸羹	fei'cui'gan'bei'dong'rong'geng
翡翠桃仁鸡	fei'cui'tao'ren'ji
翡翠玉扇	fei'cui'yu'shan
翡翠瑶柱羹	fei'cui'yao'zhu'geng
翡翠裙边	fei'cui'qun'bian
翡翠豆腐	fei'cui'dou'fu
翡翠银耳	fei'cui'yin'er
翡翠鱼丁	fei'cui'yu'ding
翡翠鱼珠	fei'cui'yu'zhu
翡翠鱼粥	fei'cui'yu'zhou
翡翠鸡翅	fei'cui'ji'chi
翡翠鸳鸯带	fei'cui'yuan'yang'dai
翻糖国际象棋蛋糕	fan'tang'guo'ji'xiang'qi'dan'gao
老世泰糕点	lao'shi'tai'gao'dian
老八大	lao'ba'da
老大房月饼	lao'da'fang'yue'bing
老妈子带鱼	lao'ma'zi'dai'yu
老姜枸杞羊肉汤	lao'jiang'gou'qi'yang'rou'tang
老姜汤	lao'jiang'tang
老婆饼	lao'po'bing
老孙家羊肉泡	lao'sun'jia'yang'rou'pao
老巴布	lao'ba'bu
老板鱼酸菜炖豆腐汤	lao'ban'yu'suan'cai'dun'dou'fu'tang
老椰	lao'ye
老汤姆毡酒	lao'tang'mu'zhan'jiu
老汤姆金酒	lao'tang'mu'jin'jiu
老科曼	lao'ke'man
老童家腊羊肉	lao'tong'jia'la'yang'rou
老竹大方茶	lao'zhu'da'fang'cha
老翅散	lao'chi'san
老酒	lao'jiu
老鸭淮杞汤	lao'ya'huai'qi'tang
老鸭炖虫草	lao'ya'dun'chong'cao
老黄瓜陈肾汤	lao'huang'gua'chen'shen'tang
老鼎丰月饼	lao'ding'feng'yue'bing
考维	kao'wei
耕之灵	geng'zhi'ling
耗儿鱼	hao'er'yu
联苯醚	lian'ben'mi
聚丁烯	ju'ding'xi
聚三鲜	ju'san'xian
聚乙二醇	ju'yi'er'chun
聚乙烯醇	ju'yi'xi'chun
聚乙烯	ju'yi'xi
聚乙酸乙烯酯	ju'yi'suan'yi'xi'zhi
聚二甲基硅氧烷	ju'er'jia'ji'gui'yang'wan
聚异丁烯	ju'yi'ding'xi
聚氧丙烯氧化乙烯甘油醚	ju'yang'bing'xi'yang'hua'yi'xi'gan'you'mi
聚氧丙烯甘油醚	ju'yang'bing'xi'gan'you'mi
聚氧乙烯山梨醇酐单月桂酸酯	ju'yang'yi'xi'shan'li'chun'gan'dan'yue'gui'suan'zhi
聚氧乙烯山梨醇酐单棕榈酸酯	ju'yang'yi'xi'shan'li'chun'gan'dan'zong'lv'suan'zhi
聚氧乙烯山梨醇酐单油酸酯	ju'yang'yi'xi'shan'li'chun'gan'dan'you'suan'zhi
聚氧乙烯山梨醇酐单硬脂酸酯	ju'yang'yi'xi'shan'li'chun'gan'dan'ying'zhi'suan'zhi
聚氧乙烯木糖醇酐单硬脂酸酯	ju'yang'yi'xi'mu'tang'chun'gan'dan'ying'zhi'suan'zhi
聚氧乙烯聚氧丙烯季戊四醇醚	ju'yang'yi'xi'ju'yang'bing'xi'ji'wu'si'chun'mi
聚氧乙烯聚氧丙烯胺醚	ju'yang'yi'xi'ju'yang'bing'xi'an'mi
聚氧乙烯聚氧丙醇胺醚	ju'yang'yi'xi'ju'yang'bing'chun'an'mi
聚甘油单硬脂酸酯	ju'gan'you'dan'ying'zhi'suan'zhi
聚甘油脂肪酸酯	ju'gan'you'zhi'fang'suan'zhi
聚甘油蓖麻醇酯	ju'gan'you'bi'ma'chun'zhi
聚葡萄糖	ju'pu'tao'tang
聪明银杏茶	cong'ming'yin'xing'cha
肉丁辣酱	rou'ding'la'jiang
肉丝拌芹菜	rou'si'ban'qin'cai
肉丝粉皮	rou'si'fen'pi
肉丸胡辣汤	rou'wan'hu'la'tang
肉夹馍	rou'jia'mo
肉末烙饼	rou'mo'lao'bing
肉末烧茄子	rou'mo'shao'qie'zi
肉末烧茄	rou'mo'shao'qie
肉末烧饼	rou'mo'shao'bing
肉松元宝蛋糕	rou'song'yuan'bao'dan'gao
肉松卷	rou'song'juan
肉松咕咕霍夫面包	rou'song'gu'gu'huo'fu'mian'bao
肉松面包	rou'song'mian'bao
肉桂油	rou'gui'you
肉桂醛	rou'gui'quan
肉汤圆	rou'tang'yuan
肉片汤	rou'pian'tang
肉片炒莴笋	rou'pian'chao'wo'sun
肉片烧茄子	rou'pian'shao'qie'zi
肉片焖扁豆	rou'pian'men'bian'dou
肉眼	rou'yan
肉碎豉椒炒豇豆	rou'sui'chi'jiao'chao'jiang'dou
肉米鱼唇	rou'mi'yu'chun
肉类罐头	rou'lei'guan'tou
肉罐头	rou'guan'tou
肉脯蛋卷	rou'pu'dan'juan
肉苁蓉海参炖瘦肉	rou'cong'rong'hai'shen'dun'shou'rou
肉苁蓉炖羊肉	rou'cong'rong'dun'yang'rou
肉苁蓉炖羊肾	rou'cong'rong'dun'yang'shen
肉茸菠菜	rou'rong'bo'cai
肉豆蔻衣粉	rou'dou'kou'yi'fen
肉质果	rou'zhi'guo
肉酱茄子	rou'jiang'qie'zi
肉酿生麸圆	rou'niang'sheng'fu'yuan
肌苷酸二钠	ji'gan'suan'er'na
肌醇六磷酸钠	ji'chun'liu'lin'suan'na
肌醇	ji'chun
肝糕汤	gan'gao'tang
肥肠笼笼	fei'chang'long'long
肥肠豆花	fei'chang'dou'hua
肴肉	yao'rou
肴驴肉	yao'lv'rou
胆钙化醇	dan'gai'hua'chun
胡桃豆腐羹	hu'tao'dou'fu'geng
胡桃龙眼鸡丁	hu'tao'long'yan'ji'ding
胡椒博士	hu'jiao'bo'shi
胡椒海参汤	hu'jiao'hai'shen'tang
胡萝卜排骨汤	hu'luo'bo'pai'gu'tang
胡萝卜生鱼汤	hu'luo'bo'sheng'yu'tang
胡萝卜素	hu'luo'bo'su
胡萝卜草莓汁	hu'luo'bo'cao'mei'zhi
胡萝卜蛋糕	hu'luo'bo'dan'gao
胭脂树橙红	yan'zhi'shu'cheng'hong
胭脂红铝色淀	yan'zhi'hong'lv'se'dian
胭脂红	yan'zhi'hong
胭脂虫红	yan'zhi'chong'hong
胶姆糖基础剂	jiao'mu'tang'ji'chu'ji
脂油年糕	zhi'you'nian'gao
脂肪酸单甘油脂	zhi'fang'suan'dan'gan'you'zhi
脂肪酸蔗糖酯	zhi'fang'suan'zhe'tang'zhi
脆松糖	cui'song'tang
脆炸火龙果	cui'zha'huo'long'guo
脆炸网油卷	cui'zha'wang'you'juan
脆瓜里脊丝	cui'gua'li'ji'si
脆皮乳鸽	cui'pi'ru'ge
脆皮卷	cui'pi'juan
脆皮大肠	cui'pi'da'chang
脆皮抹茶泡芙	cui'pi'mo'cha'pao'fu
脆皮桂鱼	cui'pi'gui'yu
脆皮炸鲜奶	cui'pi'zha'xian'nai
脆皮炸鸡	cui'pi'zha'ji
脆皮肠	cui'pi'chang
脆皮锅魁	cui'pi'guo'kui
脆皮马蹄糕	cui'pi'ma'ti'gao
脆皮鱼香牛肉	cui'pi'yu'xiang'niu'rou
脆皮鲜奶	cui'pi'xian'nai
脆皮鲜果球	cui'pi'xian'guo'qiu
脆皮鸡	cui'pi'ji
脆皮鸳鸯糕	cui'pi'yuan'yang'gao
脆蜜馃	cui'mi'guo
脆香羊米	cui'xiang'yang'mi
脐橙	qi'cheng
脑磷脂	nao'lin'zhi
脯酥金鱼	pu'su'jin'yu
脱乙酰甲壳素	tuo'yi'xian'jia'qiao'su
脱氢乙酸钠	tuo'qing'yi'suan'na
脱氢乙酸	tuo'qing'yi'suan
脱氢圆柚酮	tuo'qing'yuan'you'tong
脱脂奶粉	tuo'zhi'nai'fen
脱脂牛奶	tuo'zhi'niu'nai
脱苦杏仁罐头	tuo'ku'xing'ren'guan'tou
腊兔肉	la'tu'rou
腊味合蒸	la'wei'he'zheng
腊味煲仔饭	la'wei'bao'zai'fan
腊味芋头糕	la'wei'yu'tou'gao
腊汁肉	la'zhi'rou
腊肉炒菜苔	la'rou'chao'cai'tai
腌牛脚筋	yan'niu'jiao'jin
腌肉炒辣菜	yan'rou'chao'la'cai
腌腊肉	yan'la'rou
腌鲜桂鱼	yan'xian'gui'yu
腌鲜鳜鱼	yan'xian'gui'yu
腐乳饼	fu'ru'bing
腐皮包黄鱼	fu'pi'bao'huang'yu
腐皮肉卷	fu'pi'rou'juan
腐皮虾包	fu'pi'xia'bao
腐竹豌豆粥	fu'zhu'wan'dou'zhou
腰果虾球	yao'guo'xia'qiu
腰果鸡丁	yao'guo'ji'ding
腰片豆腐汤	yao'pian'dou'fu'tang
膨松剂	peng'song'ji
臊子豆花	sao'zi'dou'hua
自制果冻	zi'zhi'guo'dong
自制汽水	zi'zhi'qi'shui
自制沙琪玛	zi'zhi'sha'qi'ma
自来白月饼	zi'lai'bai'yue'bing
自来红月饼	zi'lai'hong'yue'bing
自贡水煮牛肉	zi'gong'shui'zhu'niu'rou
自酥饼	zi'su'bing
臭鳜鱼	chou'gui'yu
致中和养生酒	zhi'zhong'he'yang'sheng'jiu
舒沨酒	shu'feng'jiu
舟山海鲜面	zhou'shan'hai'xian'mian
艄公号子鱼	shao'gong'hao'zi'yu
色果子	se'guo'zi
色香味俱全	se'xiang'wei'ju'quan
艾仁	ai'ren
艾克力泡芙	ai'ke'li'pao'fu
艾克雷亚	ai'ke'lei'ya
艾叶生姜煨鸡蛋	ai'ye'sheng'jiang'wei'ji'dan
艾窝窝	ai'wo'wo
艾蒿糕	ai'hao'gao
节路顿树胶	jie'lu'dun'shu'jiao
芋头糕	yu'tou'gao
芋头酥	yu'tou'su
芋香红豆沙	yu'xiang'hong'dou'sha
芒果冰淇淋乳酪蛋糕	mang'guo'bing'qi'lin'ru'lao'dan'gao
芒果奶酪蛋糕	mang'guo'nai'lao'dan'gao
芒果果泥	mang'guo'guo'ni
芒果色拉	mang'guo'se'la
芒果芝士蛋糕	mang'guo'zhi'shi'dan'gao
芙蓉四宝	fu'rong'si'bao
芙蓉大虾	fu'rong'da'xia
芙蓉套蟹	fu'rong'tao'xie
芙蓉干贝	fu'rong'gan'bei
芙蓉海参	fu'rong'hai'shen
芙蓉海底	fu'rong'hai'di
芙蓉海蚌	fu'rong'hai'bang
芙蓉燕菜	fu'rong'yan'cai
芙蓉糕	fu'rong'gao
芙蓉菜心	fu'rong'cai'xin
芙蓉蛋	fu'rong'dan
芙蓉蟹	fu'rong'xie
芙蓉鱼角	fu'rong'yu'jiao
芙蓉鱼骨	fu'rong'yu'gu
芙蓉鲫鱼	fu'rong'ji'yu
芙蓉鹿尾	fu'rong'lu'wei
芜湖乌饭团	wu'hu'wu'fan'tuan
芜爆山鸡	wu'bao'shan'ji
芜爆里脊	wu'bao'li'ji
芝士布朗尼	zhi'shi'bu'lang'ni
芝士海鲜盏	zhi'shi'hai'xian'zhan
芝士烟肉酿焗薯	zhi'shi'yan'rou'niang'ju'shu
芝士蛋糕	zhi'shi'dan'gao
芝士	zhi'shi
芝葱饼	zhi'cong'bing
芝香黄油蛋糕	zhi'xiang'huang'you'dan'gao
芝麻南瓜豆沙饼	zhi'ma'nan'gua'dou'sha'bing
芝麻卷	zhi'ma'juan
芝麻双耳	zhi'ma'shuang'er
芝麻小白菜	zhi'ma'xiao'bai'cai
芝麻干巴牛肉	zhi'ma'gan'ba'niu'rou
芝麻杏仁糊	zhi'ma'xing'ren'hu
芝麻汤圆	zhi'ma'tang'yuan
芝麻田鸡	zhi'ma'tian'ji
芝麻糕	zhi'ma'gao
芝麻肉丝	zhi'ma'rou'si
芝麻肉片	zhi'ma'rou'pian
芝麻苏打饼干	zhi'ma'su'da'bing'gan
芝麻茶法	zhi'ma'cha'fa
芝麻豆腐	zhi'ma'dou'fu
芝麻酥心糖	zhi'ma'su'xin'tang
芝麻酥球	zhi'ma'su'qiu
芝麻酥糖	zhi'ma'su'tang
芝麻锅炸	zhi'ma'guo'zha
芝麻鱼卷	zhi'ma'yu'juan
芝麻鱼球	zhi'ma'yu'qiu
芝麻鹿肉糕	zhi'ma'lu'rou'gao
芝麻龙眼粥	zhi'ma'long'yan'zhou
芡实果	qian'shi'guo
芡实猪肚汤	qian'shi'zhu'du'tang
芡实百合芋头煲	qian'shi'bai'he'yu'tou'bao
芡实糕	qian'shi'gao
芡茨棕树胶	qian'ci'zong'shu'jiao
芥兰炒香肠	jie'lan'chao'xiang'chang
芥兰牛肉	jie'lan'niu'rou
芥末粉	jie'mo'fen
芥末鸭膀	jie'mo'ya'bang
芥末	jie'mo
芥菜咸蛋鱼头汤	jie'cai'xian'dan'yu'tou'tang
芥辣油	jie'la'you
芦笋大虾	lu'sun'da'xia
芦笋手卷	lu'sun'shou'juan
芦笋炒牛肉	lu'sun'chao'niu'rou
芦笋炒鸡柳	lu'sun'chao'ji'liu
芦笋煎黄菜	lu'sun'jian'huang'cai
芦笋牛肉	lu'sun'niu'rou
芦笋生鱼寿司	lu'sun'sheng'yu'shou'si
芦笋罐头	lu'sun'guan'tou
芦笋虾球	lu'sun'xia'qiu
芦笋鸡块	lu'sun'ji'kuai
芦荟酒	lu'hui'jiu
芪烧活鱼	qi'shao'huo'yu
芪蒸鹌鹑	qi'zheng'an'chun
芫爆墨鱼	yuan'bao'mo'yu
芫爆肚丝	yuan'bao'du'si
芬兰面包	fen'lan'mian'bao
芬芳抹茶酥	fen'fang'mo'cha'su
芬达	fen'da
芭乐卷	ba'le'juan
芭乐	ba'le
芭蕉	ba'jiao
芮城麻片	rui'cheng'ma'pian
花儿面包	hua'er'mian'bao
花型小饼干	hua'xing'xiao'bing'gan
花开富贵	hua'kai'fu'gui
花式绣球酥	hua'shi'xiu'qiu'su
花式酥	hua'shi'su
花式麻辣小龙虾	hua'shi'ma'la'xiao'long'xia
花旗参炖水鸭	hua'qi'shen'dun'shui'ya
花旗参炖竹丝鸡	hua'qi'shen'dun'zhu'si'ji
花旗参螺头汤	hua'qi'shen'luo'tou'tang
花果茶土司	hua'guo'cha'tu'si
花果茶贝果	hua'guo'cha'bei'guo
花果黄鱼	hua'guo'huang'yu
花根	hua'gen
花椒姜枣汤	hua'jiao'jiang'zao'tang
花椒粉	hua'jiao'fen
花椒红糖汤	hua'jiao'hong'tang'tang
花椒鱼片	hua'jiao'yu'pian
花点果品	hua'dian'guo'pin
花煎饼	hua'jian'bing
花生仁拌芹菜	hua'sheng'ren'ban'qin'cai
花生仁	hua'sheng'ren
花生大枣猪蹄汤	hua'sheng'da'zao'zhu'ti'tang
花生奶油夹	hua'sheng'nai'you'jia
花生奶油小面包	hua'sheng'nai'you'xiao'mian'bao
花生支竹鱼头汤	hua'sheng'zhi'zhu'yu'tou'tang
花生枣	hua'sheng'zao
花生桂圆红枣汤	hua'sheng'gui'yuan'hong'zao'tang
花生油	hua'sheng'you
花生烘糕	hua'sheng'hong'gao
花生猪蹄	hua'sheng'zhu'ti
花生糕	hua'sheng'gao
花生红米饭	hua'sheng'hong'mi'fan
花生芝麻糕	hua'sheng'zhi'ma'gao
花生衣红	hua'sheng'yi'hong
花生豆罐	hua'sheng'dou'guan
花生酥心糖	hua'sheng'su'xin'tang
花生酥	hua'sheng'su
花生酱小蛋糕	hua'sheng'jiang'xiao'dan'gao
花生酱糯米糍	hua'sheng'jiang'nuo'mi'ci
花生酱葱花饼	hua'sheng'jiang'cong'hua'bing
花生鸡脚汤	hua'sheng'ji'jiao'tang
花篮白菜	hua'lan'bai'cai
花胶瘦肉羹	hua'jiao'shou'rou'geng
花茹田鸡	hua'ru'tian'ji
花草堂	hua'cao'tang
花菇田鸡	hua'gu'tian'ji
花菇石鸡	hua'gu'shi'ji
花菜甜玉米	hua'cai'tian'yu'mi
花蛋糕	hua'dan'gao
花雕酒	hua'diao'jiu
花雕醉虾	hua'diao'zui'xia
花雕鸡	hua'diao'ji
花鸡腿菇	hua'ji'tui'gu
芳樟醇	fang'zhang'chun
芷江藕心香糖	zhi'jiang'ou'xin'xiang'tang
芸豆凉糕	yun'dou'liang'gao
芸豆金鱼	yun'dou'jin'yu
芹菜拌腐竹	qin'cai'ban'fu'zhu
芹菜混合汁	qin'cai'hun'he'zhi
芹菜清热利尿汤	qin'cai'qing're'li'niao'tang
芹菜牛肉丝	qin'cai'niu'rou'si
芹黄烧鱼条	qin'huang'shao'yu'tiao
芹黄鱼丝	qin'huang'yu'si
苁蓉羊肉羹	cong'rong'yang'rou'geng
苋菜红铝色淀	xian'cai'hong'lv'se'dian
苋菜红	xian'cai'hong
苏叶厚朴汤	su'ye'hou'po'tang
苏州茉莉花茶	su'zhou'mo'li'hua'cha
苏州话梅	su'zhou'hua'mei
苏式清水玫瑰月饼	su'shi'qing'shui'mei'gui'yue'bing
苏式点心	su'shi'dian'xin
苏式百果月饼	su'shi'bai'guo'yue'bing
苏式蒸蛋糕	su'shi'zheng'dan'gao
苏式蜜饯	su'shi'mi'jian
苏式鲜肉月饼	su'shi'xian'rou'yue'bing
苏打水	su'da'shui
苏打饼干	su'da'bing'gan
苏格兰之晨	su'ge'lan'zhi'chen
苏稽米花糖	su'ji'mi'hua'tang
苏菜	su'cai
苔干羊肉丝	tai'gan'yang'rou'si
苔菜千层酥	tai'cai'qian'ceng'su
苔菜小方烤	tai'cai'xiao'fang'kao
苔菜明虾	tai'cai'ming'xia
苔菜油占子	tai'cai'you'zhan'zi
苕酥糖	shao'su'tang
苗家咂酒	miao'jia'za'jiu
苗特牌	miao'te'pai
苞谷酒	bao'gu'jiu
苞谷香米	bao'gu'xiang'mi
苣荬菜包子	qu'mai'cai'bao'zi
苦丁茶	ku'ding'cha
苦中作乐	ku'zhong'zuo'le
苦瓜木棉花煲牛肉汤	ku'gua'mu'mian'hua'bao'niu'rou'tang
苦瓜粥	ku'gua'zhou
苦瓜酿肉	ku'gua'niang'rou
苦瓜鳝鱼汤	ku'gua'shan'yu'tang
苦瓜鸡片	ku'gua'ji'pian
苦瓜黑鱼汤	ku'gua'hei'yu'tang
苦艾酒	ku'ai'jiu
苯乙酸甲酯	ben'yi'suan'jia'zhi
苯乙酸	ben'yi'suan
苯乙醇	ben'yi'chun
苯乙醛	ben'yi'quan
苯基苯酚钠	ben'ji'ben'fen'na
苯基苯酚	ben'ji'ben'fen
苯甲酸苄酯	ben'jia'suan'bian'zhi
苯甲酸钠	ben'jia'suan'na
苯甲酸	ben'jia'suan
苯甲醇	ben'jia'chun
苯甲醛	ben'jia'quan
英德红茶	ying'de'hong'cha
英雄本色	ying'xiong'ben'se
苹果卷	ping'guo'juan
苹果啤酒	ping'guo'pi'jiu
苹果奶油蛋糕	ping'guo'nai'you'dan'gao
苹果沙司罐头	ping'guo'sha'si'guan'tou
苹果派	ping'guo'pai
苹果炖鱼	ping'guo'dun'yu
苹果牛肉炖煮	ping'guo'niu'rou'dun'zhu
苹果甜果汁	ping'guo'tian'guo'zhi
苹果白兰地咖啡	ping'guo'bai'lan'di'ka'fei
苹果粟米鸡肉羹	ping'guo'su'mi'ji'rou'geng
苹果脯和核桃仁罐头	ping'guo'pu'he'he'tao'ren'guan'tou
苹果菠萝生姜汁	ping'guo'bo'luo'sheng'jiang'zhi
苹果蛋糕	ping'guo'dan'gao
苹果酸	ping'guo'suan
苹果醋	ping'guo'cu
苹果雪耳煲雪梨	ping'guo'xue'er'bao'xue'li
苹果马提尼	ping'guo'ma'ti'ni
茄子煮花甲	qie'zi'zhu'hua'jia
茄子粥	qie'zi'zhou
茄汁冬瓜排	qie'zhi'dong'gua'pai
茄汁明虾	qie'zhi'ming'xia
茄汁牛肉汤	qie'zhi'niu'rou'tang
茄汁牛肉饼	qie'zhi'niu'rou'bing
茄汁牛蒡鸡块	qie'zhi'niu'bang'ji'kuai
茄汁猪排	qie'zhi'zhu'pai
茄汁菜包	qie'zhi'cai'bao
茄汁萝卜排	qie'zhi'luo'bo'pai
茄汁薯枣	qie'zhi'shu'zao
茄汁鱼卷	qie'zhi'yu'juan
茄汁鱼罐头	qie'zhi'yu'guan'tou
茄汁鳕鱼	qie'zhi'xue'yu
茄汁鸡肉	qie'zhi'ji'rou
茄汤焗香鸡	qie'tang'ju'xiang'ji
茄片吐司	qie'pian'tu'si
茅台国典	mao'tai'guo'dian
茅台	mao'tai
茅粮	mao'liang
茅麓旗枪	mao'lu'qi'qiang
茉莉浸膏	mo'li'jin'gao
茉莉鱼丁	mo'li'yu'ding
茭白炒毛豆	jiao'bai'chao'mao'dou
茯苓糕	fu'ling'gao
茯苓金菇	fu'ling'jin'gu
茯苓银耳鸽蛋	fu'ling'yin'er'ge'dan
茯苓饼干	fu'ling'bing'gan
茯苓饼	fu'ling'bing
茴香基丙酮	hui'xiang'ji'bing'tong
茴香粥	hui'xiang'zhou
茴香醇	hui'xiang'chun
茶叶熏鸡	cha'ye'xun'ji
茶叶粥	cha'ye'zhou
茶叶鲫鱼汤	cha'ye'ji'yu'tang
茶吡咯	cha'bi'luo
茶多酚	cha'duo'fen
茶树菇	cha'shu'gu
茶汤	cha'tang
茶熏八爪鱼	cha'xun'ba'zhua'yu
茶绿色素	cha'lv'se'su
茶食刀切	cha'shi'dao'qie
茶饼	cha'bing
茶香马拉糕	cha'xiang'ma'la'gao
茶香骨	cha'xiang'gu
茶黄色素	cha'huang'se'su
茸汤广肚	rong'tang'guang'du
荆沙鱼糕	jing'sha'yu'gao
草莓优酪乳	cao'mei'you'lao'ru
草莓夹心面包	cao'mei'jia'xin'mian'bao
草莓奶油蛋糕	cao'mei'nai'you'dan'gao
草莓小点心	cao'mei'xiao'dian'xin
草莓慕斯	cao'mei'mu'si
草莓摩司	cao'mei'mo'si
草莓果泥	cao'mei'guo'ni
草莓水果塔	cao'mei'shui'guo'ta
草莓绿豆粥	cao'mei'lv'dou'zhou
草莓芝士蛋糕	cao'mei'zhi'shi'dan'gao
草莓达瓦	cao'mei'da'wa
草莓酱	cao'mei'jiang
草莓龙舌兰	cao'mei'long'she'lan
草菇烧笋	cao'gu'shao'sun
草菇	cao'gu
草香园	cao'xiang'yuan
荔枝罐头	li'zhi'guan'tou
荔枝肉球	li'zhi'rou'qiu
荔枝肉	li'zhi'rou
荔枝茶	li'zhi'cha
荔枝酥	li'zhi'su
荔枝鱿鱼卷	li'zhi'you'yu'juan
荔枝鱿鱼	li'zhi'you'yu
荞面包子	qiao'mian'bao'zi
荞面包	qiao'mian'bao
荞面饸饹	qiao'mian'he'le
荞麦红豆包	qiao'mai'hong'dou'bao
荞麦面扒糕	qiao'mai'mian'pa'gao
荠菜干贝羹	ji'cai'gan'bei'geng
荠菜肉馄饨	ji'cai'rou'hun'tun
荠菜鱼卷	ji'cai'yu'juan
荣和牌	rong'he'pai
荣氏	rong'shi
荣耀去核黑橄榄	rong'yao'qu'he'hei'gan'lan
荤罗汉	hun'luo'han
荤豆花	hun'dou'hua
药膳煲水鱼	yao'shan'bao'shui'yu
荷兰毡酒	he'lan'zhan'jiu
荷兰水	he'lan'shui
荷包圆子	he'bao'yuan'zi
荷包水鱼	he'bao'shui'yu
荷包蟹肉	he'bao'xie'rou
荷包豆腐	he'bao'dou'fu
荷包鱿鱼	he'bao'you'yu
荷包鲜肉	he'bao'xian'rou
荷叶三蒸	he'ye'san'zheng
荷叶乌鸡汤	he'ye'wu'ji'tang
荷叶凤脯	he'ye'feng'pu
荷叶排骨	he'ye'pai'gu
荷叶柠檬瘦肉汤	he'ye'ning'meng'shou'rou'tang
荷叶米粉鸡	he'ye'mi'fen'ji
荷叶粉蒸鸡	he'ye'fen'zheng'ji
荷叶粥	he'ye'zhou
荷叶肉	he'ye'rou
荷叶蒸鱼	he'ye'zheng'yu
荷叶鸡	he'ye'ji
荷塘莲香	he'tang'lian'xiang
荷月	he'yue
荷煲老鸭汤	he'bao'lao'ya'tang
荷花干贝汤	he'hua'gan'bei'tang
荷花蛋糕	he'hua'dan'gao
荷花豆腐大虾	he'hua'dou'fu'da'xia
荷花酥	he'hua'su
荷花金鱼虾	he'hua'jin'yu'xia
荷花鱼翅	he'hua'yu'chi
荷芹炒腊味	he'qin'chao'la'wei
荸荠山楂粥	bi'qi'shan'zha'zhou
荸荠萝卜粥	bi'qi'luo'bo'zhou
莫基多	mo'ji'duo
莫干黄芽茶	mo'gan'huang'ya'cha
莫等肉松做面包	mo'deng'rou'song'zuo'mian'bao
莱姆费兹	lai'mu'fei'zi
莱姆	lai'mu
莱开欧胶	lai'kai'ou'jiao
莲子心甘草茶	lian'zi'xin'gan'cao'cha
莲子润肤粥	lian'zi'run'fu'zhou
莲子猪心汤	lian'zi'zhu'xin'tang
莲子百合糯米粥	lian'zi'bai'he'nuo'mi'zhou
莲子糕	lian'zi'gao
莲子紫米粥	lian'zi'zi'mi'zhou
莲子膳粥	lian'zi'shan'zhou
莲子营养粉	lian'zi'ying'yang'fen
莲子西瓜粥	lian'zi'xi'gua'zhou
莲子银耳梨	lian'zi'yin'er'li
莲子鸡丁	lian'zi'ji'ding
莲花卷	lian'hua'juan
莲花蛋糕	lian'hua'dan'gao
莲茸层层酥	lian'rong'ceng'ceng'su
莲蓉甘露酥	lian'rong'gan'lu'su
莲蓉芝麻球	lian'rong'zhi'ma'qiu
莲蓉酥饼	lian'rong'su'bing
莲香脱骨鸡	lian'xiang'tuo'gu'ji
莳萝草籽	shi'luo'cao'zi
莳萝草	shi'luo'cao
莴笋叶子	wo'sun'ye'zi
莴笋拌白肉	wo'sun'ban'bai'rou
莴笋	wo'sun
莼菜黄鱼羹	chun'cai'huang'yu'geng
莼菜	chun'cai
菁岛啤酒	jing'dao'pi'jiu
菊枣蜂蜜露	ju'zao'feng'mi'lu
菊花冬笋	ju'hua'dong'sun
菊花对蟹	ju'hua'dui'xie
菊花枸杞茶	ju'hua'gou'qi'cha
菊花榨菜鱼卷	ju'hua'zha'cai'yu'juan
菊花海鲜锅	ju'hua'hai'xian'guo
菊花火锅	ju'hua'huo'guo
菊花猪肝汤	ju'hua'zhu'gan'tang
菊花糕	ju'hua'gao
菊花豆腐	ju'hua'dou'fu
菊花酥饼	ju'hua'su'bing
菊花里脊	ju'hua'li'ji
菊花锅子	ju'hua'guo'zi
菊花锅	ju'hua'guo
菊花青鱼	ju'hua'qing'yu
菊花鱼丸	ju'hua'yu'wan
菊花鱿鱼	ju'hua'you'yu
菊花鲈鱼	ju'hua'lu'yu
菊花黄浸膏	ju'hua'huang'jin'gao
菊花龙虎凤蛇羹	ju'hua'long'hu'feng'she'geng
菜合	cai'he
菜干扣肉	cai'gan'kou'rou
菜干鸭肾蜜枣汤	cai'gan'ya'shen'mi'zao'tang
菜心炒猪肝	cai'xin'chao'zhu'gan
菜心烧肉鱼干	cai'xin'shao'rou'yu'gan
菜籽油	cai'zi'you
菜蟒	cai'mang
菜豆腐稀饭	cai'dou'fu'xi'fan
菜豆腐节节	cai'dou'fu'jie'jie
菜豆花	cai'dou'hua
菜远牛肉	cai'yuan'niu'rou
菠菜丸子汤	bo'cai'wan'zi'tang
菠菜大枣粥	bo'cai'da'zao'zhou
菠菜煎饼	bo'cai'jian'bing
菠菜蛋蓉	bo'cai'dan'rong
菠菜金钩豆腐汤	bo'cai'jin'gou'dou'fu'tang
菠菜鸡煲	bo'cai'ji'bao
菠菜鸡蛋汤	bo'cai'ji'dan'tang
菠菜鸭肝汤	bo'cai'ya'gan'tang
菠萝三文鱼	bo'luo'san'wen'yu
菠萝包	bo'luo'bao
菠萝圆片	bo'luo'yuan'pian
菠萝罐头	bo'luo'guan'tou
菠萝蜜	bo'luo'mi
菠萝鳜鱼	bo'luo'gui'yu
菠萝鸡丁	bo'luo'ji'ding
菠萝龙眼鱼	bo'luo'long'yan'yu
菠饺鱼肚	bo'jiao'yu'du
菠饺鱿鱼方	bo'jiao'you'yu'fang
菱角	ling'jiao
萍乡花果	ping'xiang'hua'guo
萍乡驴肉	ping'xiang'lv'rou
萍踪叠影	ping'zong'die'ying
萝卜丝饼	luo'bo'si'bing
萝卜奶汁	luo'bo'nai'zhi
萝卜桂鱼	luo'bo'gui'yu
萝卜氽鲫鱼	luo'bo'tun'ji'yu
萝卜汁粥	luo'bo'zhi'zhou
萝卜泡菜	luo'bo'pao'cai
萝卜炖羊肉	luo'bo'dun'yang'rou
萝卜烧排骨	luo'bo'shao'pai'gu
萝卜牛百叶汤	luo'bo'niu'bai'ye'tang
萝卜红	luo'bo'hong
萝卜连锅汤	luo'bo'lian'guo'tang
萝卜鲜虾	luo'bo'xian'xia
萝蔔丝酥饼	luo'bo'si'su'bing
营养强化剂	ying'yang'qiang'hua'ji
营养快线	ying'yang'kuai'xian
营养藕粉	ying'yang'ou'fen
营养青菜钵	ying'yang'qing'cai'bo
萧山杨梅	xiao'shan'yang'mei
萧山花边	xiao'shan'hua'bian
萧山萝卜干	xiao'shan'luo'bo'gan
萨其玛	sa'qi'ma
萨拉米	sa'la'mi
萨琪玛桃	sa'qi'ma'tao
萨琪玛	sa'qi'ma
落叶琵琶虾	luo'ye'pi'pa'xia
落葵红	luo'kui'hong
葛根清肺汤	ge'gen'qing'fei'tang
葡式蛋挞	pu'shi'dan'ta
葡皇世家	pu'huang'shi'jia
葡聚糖酶	pu'ju'tang'mei
葡萄仿	pu'tao'fang
葡萄干低糖蛋糕卷	pu'tao'gan'di'tang'dan'gao'juan
葡萄干炒饭	pu'tao'gan'chao'fan
葡萄干	pu'tao'gan
葡萄柚	pu'tao'you
葡萄汁	pu'tao'zhi
葡萄皮红	pu'tao'pi'hong
葡萄籽提取物	pu'tao'zi'ti'qu'wu
葡萄糖酸亚铁	pu'tao'tang'suan'ya'tie
葡萄糖酸内酯	pu'tao'tang'suan'nei'zhi
葡萄糖酸钙	pu'tao'tang'suan'gai
葡萄糖酸钾	pu'tao'tang'suan'jia
葡萄糖酸铜	pu'tao'tang'suan'tong
葡萄糖酸锌	pu'tao'tang'suan'xin
葡萄糖酸锰	pu'tao'tang'suan'meng
葡萄糖酸镁	pu'tao'tang'suan'mei
葡萄菠萝杏汁	pu'tao'bo'luo'xing'zhi
葡萄酒	pu'tao'jiu
葡萄面排	pu'tao'mian'pai
葡萄香芋月饼	pu'tao'xiang'yu'yue'bing
葫芦大吉翅子	hu'lu'da'ji'chi'zi
葫芦头	hu'lu'tou
葫芦巴胶	hu'lu'ba'jiao
葫芦鸡	hu'lu'ji
葱包桧	cong'bao'gui
葱段海参	cong'duan'hai'can
葱油发面饼	cong'you'fa'mian'bing
葱油核桃鱼卷	cong'you'he'tao'yu'juan
葱油桃酥	cong'you'tao'su
葱油苦瓜	cong'you'ku'gua
葱油蒸鸭	cong'you'zheng'ya
葱油蛋糕	cong'you'dan'gao
葱油酥	cong'you'su
葱油饼	cong'you'bing
葱油鸡	cong'you'ji
葱油黄鱼	cong'you'huang'yu
葱炖猪蹄	cong'dun'zhu'ti
葱烧海参	cong'shao'hai'shen
葱爆兔肉	cong'bao'tu'rou
葱爆羊肉丁	cong'bao'yang'rou'ding
葱爆羊肉	cong'bao'yang'rou
葱爆肉丝	cong'bao'rou'si
葱白鸡蛋汤	cong'bai'ji'dan'tang
葱穿排骨	cong'chuan'pai'gu
葱花炒蛋	cong'hua'chao'dan
葱花缸炉	cong'hua'gang'lu
葱豉豆腐汤	cong'chi'dou'fu'tang
葱辣鱼条	cong'la'yu'tiao
葱辣鱼脯	cong'la'yu'pu
葱辣鱼	cong'la'yu
葱饼	cong'bing
葵花虾饼	kui'hua'xia'bing
葵花酥饼	kui'hua'su'bing
葵醛	kui'quan
蒙特利尔牛排调料	meng'te'li'er'niu'pai'tiao'liao
蒙自年糕	meng'zi'nian'gao
蒙顶茶	meng'ding'cha
蒜味爽肚	suan'wei'shuang'du
蒜头粉大蒜粉	suan'tou'fen'da'suan'fen
蒜子瑶柱脯	suan'zi'yao'zhu'pu
蒜子瑶柱豆苗	suan'zi'yao'zhu'dou'miao
蒜拌空心菜	suan'ban'kong'xin'cai
蒜泥茄子	suan'ni'qie'zi
蒜泥黄瓜	suan'ni'huang'gua
蒜爆肉	suan'bao'rou
蒜苗火鸡排	suan'miao'huo'ji'pai
蒜苗炒虾	suan'miao'chao'xia
蒜蓉辣椒鲜鱿煲	suan'rong'la'jiao'xian'you'bao
蒜薹烧肉	suan'tai'shao'rou
蒜香煎海虾	suan'xiang'jian'hai'xia
蒜香豆豉蒸扇贝	suan'xiang'dou'chi'zheng'shan'bei
蒜香鲶鱼	suan'xiang'nian'yu
蒟蒻凉拌	ju'ruo'liang'ban
蒲公英节	pu'gong'ying'jie
蒲江猪油米花糖	pu'jiang'zhu'you'mi'hua'tang
蒲江蟹羹	pu'jiang'xie'geng
蒸上白糖切糕	zheng'shang'bai'tang'qie'gao
蒸南瓜	zheng'nan'gua
蒸扒三丝干贝	zheng'ba'san'si'gan'bei
蒸江团	zheng'jiang'tuan
蒸熊掌	zheng'xiong'zhang
蒸箱	zheng'xiang
蒸糕	zheng'gao
蒸羊羔儿	zheng'yang'gao'er
蒸面	zheng'mian
蒸馏酒	zheng'liu'jiu
蒸鲳鱼	zheng'chang'yu
蒸鹿尾儿	zheng'lu'wei'er
蒿杆炒鳝丝	hao'gan'chao'shan'si
蓉城鸳鸯卷	rong'cheng'yuan'yang'juan
蓝力	lan'li
蓝圣斯	lan'sheng'si
蓝城	lan'cheng
蓝带	lan'dai
蓝色珊瑚礁	lan'se'shan'hu'jiao
蓝色香槟	lan'se'xiang'bin
蓝莓冻芝士蛋糕	lan'mei'dong'zhi'shi'dan'gao
蓝莓奶酪	lan'mei'nai'lao
蓝莓巧心饼	lan'mei'qiao'xin'bing
蓝莓慕丝	lan'mei'mu'si
蓝莓果泥	lan'mei'guo'ni
蓝莓罐头	lan'mei'guan'tou
蓝莓芝士	lan'mei'zhi'shi
蓝莓蛋糕	lan'mei'dan'gao
蓝莓酸奶蛋糕	lan'mei'suan'nai'dan'gao
蓝锭果红	lan'ding'guo'hong
蓬莱仙芝茶	peng'lai'xian'zhi'cha
蓬莱米	peng'lai'mi
蓼花	liao'hua
蔊菜雪梨冰糖汁	han'cai'xue'li'bing'tang'zhi
蔗糖素	zhe'tang'su
蔗糖脂肪酸酯	zhe'tang'zhi'fang'suan'zhi
蔗糖酯	zhe'tang'zhi
蔡氏	cai'shi
蔬菜丝沙拉	shu'cai'si'sha'la
蔬菜厚蛋烧	shu'cai'hou'dan'shao
蔬菜汤	shu'cai'tang
蔬菜玉米麦片粥	shu'cai'yu'mi'mai'pian'zhou
蕃茄鸡煲	fan'qie'ji'bao
蕨根粉煮鳝鱼	jue'gen'fen'zhu'shan'yu
薄玉茶	bo'yu'cha
薄筋光煎稀汪酸辣香	bo'jin'guang'jian'xi'wang'suan'la'xiang
薄脆饼干	bao'cui'bing'gan
薄荷叶松香	bo'he'ye'song'xiang
薄荷叶	bo'he'ye
薄荷水蜜糕	bo'he'shui'mi'gao
薄荷糕	bo'he'gao
薄荷素油	bo'he'su'you
薄荷蔬菜沙拉	bo'he'shu'cai'sha'la
薄荷薰衣草茶	bo'he'xun'yi'cao'cha
薄荷饼糖	bo'he'bing'tang
薄饼羊肉	bao'bing'yang'rou
薏仁猪肚汤	yi'ren'zhu'du'tang
薏仁罐头	yi'ren'guan'tou
薏仁苦瓜粥	yi'ren'ku'gua'zhou
薏仁荷叶甜品	yi'ren'he'ye'tian'pin
薏仁马蹄汤	yi'ren'ma'ti'tang
薏米仁	yi'mi'ren
薏米曲营养饮料	yi'mi'qu'ying'yang'yin'liao
薏米粉	yi'mi'fen
薏苡料乳酸发酵饮料	yi'yi'liao'ru'suan'fa'jiao'yin'liao
薪草提取物	xin'cao'ti'qu'wu
薯条手卷	shu'tiao'shou'juan
薰衣草饼干	xun'yi'cao'bing'gan
藁城贡面	gao'cheng'gong'mian
藏宝	cang'bao
藏心鱼圆	cang'xin'yu'yuan
藏男红	cang'nan'hong
藏花素	cang'hua'su
藏花饼	cang'hua'bing
藕丝羹	ou'si'geng
藕片汤	ou'pian'tang
藕莲饮	ou'lian'yin
藕香芹味	ou'xiang'qin'wei
藻蓝	zao'lan
蘑菇兔肉粥	mo'gu'tu'rou'zhou
蘑菇汤	mo'gu'tang
蘑菇罐头	mo'gu'guan'tou
蘑菇黄芪炖鸡汤	mo'gu'huang'qi'dun'ji'tang
蘸水卷粉	zhan'shui'juan'fen
蘸水麺	zhan'shui'mian
虎山茶	hu'shan'cha
虎皮咖啡戚风卷	hu'pi'ka'fei'qi'feng'juan
虎皮核桃仁	hu'pi'he'tao'ren
虎皮梳子肉	hu'pi'shu'zi'rou
虎皮毛豆腐	hu'pi'mao'dou'fu
虎皮烩鸡丁	hu'pi'hui'ji'ding
虎皮蛋糕	hu'pi'dan'gao
虎皮香肉	hu'pi'xiang'rou
虎跑素火腿	hu'pao'su'huo'tui
虞城麻片	yu'cheng'ma'pian
虫胶红	chong'jiao'hong
虫胶	chong'jiao
虫茶	chong'cha
虫草全鸭	chong'cao'quan'ya
虫草八卦汤	chong'cao'ba'gua'tang
虫草杜仲炖海虾	chong'cao'du'zhong'dun'hai'xia
虫草汽锅鸡	chong'cao'qi'guo'ji
虫草炖鸡	chong'cao'dun'ji
虫草金钱龟精	chong'cao'jin'qian'gui'jing
虫草鸭舌	chong'cao'ya'she
虫草鹌鹑	chong'cao'an'chun
虾仁吐司	xia'ren'tu'si
虾仁萝卜脯	xia'ren'luo'bo'pu
虾仁酥	xia'ren'su
虾片粥	xia'pian'zhou
虾米拌豆腐	xia'mi'ban'dou'fu
虾米炒芹菜	xia'mi'chao'qin'cai
虾米炒黄瓜	xia'mi'chao'huang'gua
虾米	xia'mi
虾肉月饼	xia'rou'yue'bing
虾肉鸳鸯菜	xia'rou'yuan'yang'cai
虾茸酿面包	xia'rong'niang'mian'bao
虾须牛肉	xia'xu'niu'rou
蚁酒	yi'jiu
蚂蚁上树	ma'yi'shang'shu
蚕蛹罐头	can'yong'guan'tou
蚕豆炒虾仁	can'dou'chao'xia'ren
蚕豆粉	can'dou'fen
蚕豆罐头	can'dou'guan'tou
蚝油扒冬瓜	hao'you'ba'dong'gua
蚝油牛肉丝	hao'you'niu'rou'si
蚝油牛肉	hao'you'niu'rou
蚝油生菜	hao'you'sheng'cai
蚝油网鲍片	hao'you'wang'bao'pian
蚝油芦笋沙律	hao'you'lu'sun'sha'lv
蚝油蘑菇	hao'you'mo'gu
蚝油鲜菇	hao'you'xian'gu
蚝油鸭掌	hao'you'ya'zhang
蚝皇凤爪	hao'huang'feng'zhao
蛇汁茯苓糕	she'zhi'fu'ling'gao
蛇羹	she'geng
蛇蒿叶	she'hao'ye
蛋丝饼	dan'si'bing
蛋卷饼干	dan'juan'bing'gan
蛋卷	dan'juan
蛋圆饼干	dan'yuan'bing'gan
蛋奶果子饼	dan'nai'guo'zi'bing
蛋奶酥	dan'nai'su
蛋形巧克力	dan'xing'qiao'ke'li
蛋心圣女果	dan'xin'sheng'nv'guo
蛋松果	dan'song'guo
蛋烘糕	dan'hong'gao
蛋白圆蛋糕	dan'bai'yuan'dan'gao
蛋白果汁饮料	dan'bai'guo'zhi'yin'liao
蛋白混合饮料	dan'bai'hun'he'yin'liao
蛋酥土豆片	dan'su'tu'dou'pian
蛋酥花仁	dan'su'hua'ren
蛋黄凤尾白玉卷	dan'huang'feng'wei'bai'yu'juan
蛋黄千层糕	dan'huang'qian'ceng'gao
蛋黄卷	dan'huang'juan
蛋黄土豆饼	dan'huang'tu'dou'bing
蛋黄果	dan'huang'guo
蛋黄派	dan'huang'pai
蛋黄甘露酥	dan'huang'gan'lu'su
蛋黄莲蓉月饼	dan'huang'lian'rong'yue'bing
蛋黄酥	dan'huang'su
蛋黄酱	dan'huang'jiang
蛋黄里脊卷	dan'huang'li'ji'juan
蛋黄锅盔	dan'huang'guo'kui
蛋黄面包	dan'huang'mian'bao
蛋黄饼干	dan'huang'bing'gan
蛋黄麻花	dan'huang'ma'hua
蛏溜奇	cheng'liu'qi
蛙式黄鱼	wa'shi'huang'yu
蛤仔猪肚汤	ge'zi'zhu'du'tang
蛤蜊鲫鱼	ge'li'ji'yu
蜂巢蛋糕	feng'chao'dan'gao
蜂王软糖	feng'wang'ruan'tang
蜂窝土豆	feng'wo'tu'dou
蜂糕	feng'gao
蜂蜜凉棕子	feng'mi'liang'zong'zi
蜂蜜发酵营养饮料	feng'mi'fa'jiao'ying'yang'yin'liao
蜂蜜芦荟果粒	feng'mi'lu'hui'guo'li
蜂蜜蛋白奶糖	feng'mi'dan'bai'nai'tang
蜂蜜麻糖	feng'mi'ma'tang
蜜三刀	mi'san'dao
蜜三果	mi'san'guo
蜜制蜂糕	mi'zhi'feng'gao
蜜枣核桃	mi'zao'he'tao
蜜枣桂鱼	mi'zao'gui'yu
蜜枣洋参茶	mi'zao'yang'shen'cha
蜜枣羊肉	mi'zao'yang'rou
蜜枣银心	mi'zao'yin'xin
蜜柑	mi'gan
蜜桂花生糖	mi'gui'hua'sheng'tang
蜜桔罐头	mi'ju'guan'tou
蜜桔鸡丁	mi'ju'ji'ding
蜜汁一品肉	mi'zhi'yi'pin'rou
蜜汁叉烧包	mi'zhi'cha'shao'bao
蜜汁叉烧	mi'zhi'cha'shao
蜜汁山药	mi'zhi'shan'yao
蜜汁春鸡	mi'zhi'chun'ji
蜜汁梨球	mi'zhi'li'qiu
蜜汁火方	mi'zhi'huo'fang
蜜汁肥桃	mi'zhi'fei'tao
蜜汁金枣	mi'zhi'jin'zao
蜜瓜脆鳝	mi'gua'cui'shan
蜜瓜螺头鸡汤	mi'gua'luo'tou'ji'tang
蜜番茄	mi'fan'qie
蜜绿豆罐	mi'lv'dou'guan
蜜芙蓉	mi'fu'rong
蜜蜡肘子	mi'la'zhou'zi
蜜豆鱼片	mi'dou'yu'pian
蜜食果	mi'shi'guo
蝙蝠包	bian'fu'bao
蝙蝠莲藕	bian'fu'lian'ou
蝴蝶海参	hu'die'hai'shen
蝴蝶烩鳝	hu'die'hui'shan
蝴蝶酥	hu'die'su
螃蟹酥	pang'xie'su
螺丝盒子	luo'si'he'zi
蟠桃苹果	pan'tao'ping'guo
蟠龙菜	pan'long'cai
蟹粉西兰花	xie'fen'xi'lan'hua
蟹粉豆腐羹	xie'fen'dou'fu'geng
蟹肉烧豆腐	xie'rou'shao'dou'fu
蟹肉罐头	xie'rou'guan'tou
蟹肉羹	xie'rou'geng
蟹肉西兰花	xie'rou'xi'lan'hua
蟹肉青瓜沙律	xie'rou'qing'gua'sha'lv
蟹足棒	xie'zu'bang
蟹黄大生翅	xie'huang'da'sheng'chi
蟹黄小汤包	xie'huang'xiao'tang'bao
蟹黄扒芦笋	xie'huang'ba'lu'sun
蟹黄海参	xie'huang'hai'shen
蟹黄灌汤包	xie'huang'guan'tang'bao
蟹黄肉包	xie'huang'rou'bao
蟹黄虾盅	xie'huang'xia'zhong
蟹黄蹄筋	xie'huang'ti'jin
蟹黄鱼翅	xie'huang'yu'chi
蟾蜍水蛇粥	chan'chu'shui'she'zhou
血糯米	xue'nuo'mi
血肠	xue'chang
血蛋白糕点	xue'dan'bai'gao'dian
补肾养肝茶	bu'shen'yang'gan'cha
补血养生茶	bu'xue'yang'sheng'cha
补血羊肉乌发汤	bu'xue'yang'rou'wu'fa'tang
补血酥糖	bu'xue'su'tang
补骨饼干	bu'gu'bing'gan
衬衫蛋糕	chen'shan'dan'gao
袜底酥	wa'di'su
被膜剂	bei'mo'ji
装饰饼干	zhuang'shi'bing'gan
裤带麺	ku'dai'mian
西乡牛肉干	xi'xiang'niu'rou'gan
西亭脆饼	xi'ting'cui'bing
西兰花大龙虾	xi'lan'hua'da'long'xia
西兰花	xi'lan'hua
西冷	xi'leng
西凤特麯	xi'feng'te'qu
西印度樱桃	xi'yin'du'ying'tao
西安油酥饼	xi'an'you'su'bing
西式月饼	xi'shi'yue'bing
西式烤面包	xi'shi'kao'mian'bao
西式米花糕	xi'shi'mi'hua'gao
西式芦笋汤	xi'shi'lu'sun'tang
西式酥饼	xi'shi'su'bing
西施团圆饼	xi'shi'tuan'yuan'bing
西柚三文鱼	xi'you'san'wen'yu
西汁乳鸽	xi'zhi'ru'ge
西泠印泥	xi'ling'yin'ni
西洋参红枣炖乳鸽	xi'yang'shen'hong'zao'dun'ru'ge
西洋李子	xi'yang'li'zi
西洋烩鸡	xi'yang'hui'ji
西洋菜蜜枣鲫鱼汤	xi'yang'cai'mi'zao'ji'yu'tang
西湖保灵蜜	xi'hu'bao'ling'mi
西湖天竺筷	xi'hu'tian'zhu'kuai
西湖桂花藕粉	xi'hu'gui'hua'ou'fen
西湖绸伞	xi'hu'chou'san
西湖莼菜	xi'hu'chun'cai
西湖藕粉	xi'hu'ou'fen
西湖蜜皇彩花	xi'hu'mi'huang'cai'hua
西湖醋鱼	xi'hu'cu'yu
西湖龙井	xi'hu'long'jing
西班牙醇奶咖啡	xi'ban'ya'chun'nai'ka'fei
西瓜奶酪	xi'gua'nai'lao
西瓜汁饮料	xi'gua'zhi'yin'liao
西瓜盅	xi'gua'zhong
西瓜赤豆粥	xi'gua'chi'dou'zhou
西瓜酱罐头	xi'gua'jiang'guan'tou
西瓜鸡	xi'gua'ji
西红柿炒蛋	xi'hong'shi'chao'dan
西红柿牛肉汤	xi'hong'shi'niu'rou'tang
西红柿牛肉炖洋白菜	xi'hong'shi'niu'rou'dun'yang'bai'cai
西红柿翡翠面	xi'hong'shi'fei'cui'mian
西红柿肉片汤	xi'hong'shi'rou'pian'tang
西红柿	xi'hong'shi
西芹百合	xi'qin'bai'he
西芹虾仁	xi'qin'xia'ren
西芹鸡肫	xi'qin'ji'zhun
西芹	xi'qin
西西里面包	xi'xi'li'mian'bao
西部牛仔烧烤城	xi'bu'niu'zai'shao'kao'cheng
西餐厨师	xi'can'chu'shi
覆盆子	fu'pen'zi
观我颐猪油糕	guan'wo'yi'zhu'you'gao
视黄醇	shi'huang'chun
解百纳	jie'bai'na
解酒方	jie'jiu'fang
詹王奶白汁	zhan'wang'nai'bai'zhi
詹王火腿汁	zhan'wang'huo'tui'zhi
詹王猪骨汁	zhan'wang'zhu'gu'zhi
詹王瑶柱汁	zhan'wang'yao'zhu'zhi
詹王鸡粉	zhan'wang'ji'fen
试量狗肉	shi'liang'gou'rou
诗礼银杏	shi'li'yin'xing
诚一香辣海带	cheng'yi'xiang'la'hai'dai
诚一香辣海蜇	cheng'yi'xiang'la'hai'zhe
话梅手剥笋	hua'mei'shou'bo'sun
诱惑红铝色淀	you'huo'hong'lv'se'dian
诱惑红	you'huo'hong
诸暨西施团圆饼	zhu'ji'xi'shi'tuan'yuan'bing
诺丽	nuo'li
调味油	tiao'wei'you
调味酱	tiao'wei'jiang
调和油	tiao'he'you
谢村黄酒	xie'cun'huang'jiu
谷氨酰胺转氨酶	gu'an'xian'an'zhuan'an'mei
谷氨酰胺酶	gu'an'xian'an'mei
谷氨酸钠	gu'an'suan'na
谷雨茶	gu'yu'cha
豆乳饮料	dou'ru'yin'liao
豆乳	dou'ru
豆末糖	dou'mo'tang
豆汁	dou'zhi
豆沙凉糕	dou'sha'liang'gao
豆沙包	dou'sha'bao
豆沙方糕	dou'sha'fang'gao
豆沙月饼	dou'sha'yue'bing
豆沙松糕	dou'sha'song'gao
豆沙碗豆黄	dou'sha'wan'dou'huang
豆沙糕	dou'sha'gao
豆沙细饼	dou'sha'xi'bing
豆油	dou'you
豆泥核桃	dou'ni'he'tao
豆泥红枣	dou'ni'hong'zao
豆浆挂面	dou'jiang'gua'mian
豆渣猪头	dou'zha'zhu'tou
豆焖饭	dou'men'fan
豆瓣海参	dou'ban'hai'shen
豆瓣肘子	dou'ban'zhou'zi
豆瓣鱼条	dou'ban'yu'tiao
豆瓣鲜鱼	dou'ban'xian'yu
豆瓣鲜鱿	dou'ban'xian'you
豆瓣鲫鱼	dou'ban'ji'yu
豆腐丸子	dou'fu'wan'zi
豆腐咸鱼头汤	dou'fu'xian'yu'tou'tang
豆腐大菜糕	dou'fu'da'cai'gao
豆腐排骨	dou'fu'pai'gu
豆腐炒韭菜	dou'fu'chao'jiu'cai
豆腐芝士三明治	dou'fu'zhi'shi'san'ming'zhi
豆腐芝士蛋糕	dou'fu'zhi'shi'dan'gao
豆腐蛎	dou'fu'li
豆腐蟹肉忌廉汤	dou'fu'xie'rou'ji'lian'tang
豆腐鲫鱼	dou'fu'ji'yu
豆芽咸菜	dou'ya'xian'cai
豆芽拌粉条	dou'ya'ban'fen'tiao
豆芽汤	dou'ya'tang
豆芽罐头	dou'ya'guan'tou
豆苗炒虾片	dou'miao'chao'xia'pian
豆苗炒鸡片	dou'miao'chao'ji'pian
豆苗蘑菇汤	dou'miao'mo'gu'tang
豆苗虾仁	dou'miao'xia'ren
豆苗鸡丝	dou'miao'ji'si
豆茸酿枇杷	dou'rong'niang'pi'pa
豆角炒肉片	dou'jiao'chao'rou'pian
豆豉小辣椒	dou'chi'xiao'la'jiao
豆豉拌凉粉	dou'chi'ban'liang'fen
豆豉鱼	dou'chi'yu
豆质罐头	dou'zhi'guan'tou
豆面球	dou'mian'qiu
豆面糕	dou'mian'gao
豆面酥糖	dou'mian'su'tang
豆香麻糍	dou'xiang'ma'ci
豆鼓鱼	dou'gu'yu
豆鼓鲇鱼	dou'gu'nian'yu
豇豆烧肉	jiang'dou'shao'rou
豉椒墨鱼球	chi'jiao'mo'yu'qiu
豉椒带子豆腐	chi'jiao'dai'zi'dou'fu
豉椒炒牛肉	chi'jiao'chao'niu'rou
豉椒炒鱼干	chi'jiao'chao'yu'gan
豉椒蒸腊肉	chi'jiao'zheng'la'rou
豉汁凉瓜炆蟹	chi'zhi'liang'gua'wen'xie
豉汁蟠龙鳝	chi'zhi'pan'long'shan
豉汁鱼云	chi'zhi'yu'yun
豌豆粉	wan'dou'fen
豌豆鸡丝	wan'dou'ji'si
豌豆黄儿	wan'dou'huang'er
豌豆黄	wan'dou'huang
象眼鸽蛋	xiang'yan'ge'dan
豪坊	hao'fang
豫尔	yu'er
豹骨酒	bao'gu'jiu
贝丝扒菜胆	bei'si'ba'cai'dan
贝德利	bei'de'li
贝母沙参蒸雪梨	bei'mu'sha'shen'zheng'xue'li
贡品麻花	gong'pin'ma'hua
贡菜	gong'cai
贵妃松花饼	gui'fei'song'hua'bing
贵妃鸡火锅	gui'fei'ji'huo'guo
贵妃鸡翅	gui'fei'ji'chi
贵妃鸡	gui'fei'ji
贵州省	gui'zhou'sheng
贵州茅台	gui'zhou'mao'tai
贾三灌汤包子	jia'san'guan'tang'bao'zi
赊店老酒	she'dian'lao'jiu
赖家名酱	lai'jia'ming'jiang
赖桃酥	lai'tao'su
赖氨酸天门冬氨酸盐	lai'an'suan'tian'men'dong'an'suan'yan
赖氨酸盐酸盐	lai'an'suan'yan'suan'yan
赖汤圆	lai'tang'yuan
赛螃蟹	sai'pang'xie
赛鲍鱼	sai'bao'yu
赣州麻通	gan'zhou'ma'tong
赤藓糖醇	chi'xian'tang'chun
赤藓红铝色淀	chi'xian'hong'lv'se'dian
赤藓红	chi'xian'hong
赤藻糖醇	chi'zao'tang'chun
赤豆花生炖鲤鱼	chi'dou'hua'sheng'dun'li'yu
赤豆补脾粥	chi'dou'bu'pi'zhou
赤豆	chi'dou
赤鳞鱼	chi'lin'yu
走油肉	zou'you'rou
起司火腿夹心猪排	qi'si'huo'tui'jia'xin'zhu'pai
起司蛋糕	qi'si'dan'gao
起司	qi'si
超山梅子	chao'shan'mei'zi
超益	chao'yi
越桔	yue'ju
越橘红	yue'ju'hong
越蔓橘	yue'man'ju
路南乳饼	lu'nan'ru'bing
路易歌德	lu'yi'ge'de
踵鱼翅	zhong'yu'chi
车前子油焖虾	che'qian'zi'you'men'xia
车前子红枣田螺汤	che'qian'zi'hong'zao'tian'luo'tang
车前子茶	che'qian'zi'cha
车前草茶	che'qian'cao'cha
车前草蔗汁粥	che'qian'cao'zhe'zhi'zhou
车厘子	che'li'zi
车轮酥饼	che'lun'su'bing
轩尼诗	xuan'ni'shi
软炸石鸡	ruan'zha'shi'ji
软炸菜花	ruan'zha'cai'hua
软炸虾糕	ruan'zha'xia'gao
软炸里脊	ruan'zha'li'ji
软炸鲜贝	ruan'zha'xian'bei
软炸鸡肝	ruan'zha'ji'gan
软炸鸡	ruan'zha'ji
软烧仔鲇	ruan'shao'zai'nian
软烧豆腐	ruan'shao'dou'fu
软脂糕	ruan'zhi'gao
软蛋糕	ruan'dan'gao
软饼干	ruan'bing'gan
轻乳酪蛋糕	qing'ru'lao'dan'gao
轻质碳酸钙	qing'zhi'tan'suan'gai
轻身减肥茶	qing'shen'jian'fei'cha
辛基苯氧聚乙烯氧基	xin'ji'ben'yang'ju'yi'xi'yang'ji
辛烯基琥珀酸铝淀粉	xin'xi'ji'hu'po'suan'lv'dian'fen
辛癸酸甘油酯	xin'gui'suan'gan'you'zhi
辛酸乙酯	xin'suan'yi'zhi
辛醛	xin'quan
辣味炸鸡翅	la'wei'zha'ji'chi
辣味肉皮冻	la'wei'rou'pi'dong
辣味过江鸡	la'wei'guo'jiang'ji
辣子肥肠	la'zi'fei'chang
辣子脆肠	la'zi'cui'chang
辣子蒜羊血	la'zi'suan'yang'xue
辣子锅巴脆皮鱼丁	la'zi'guo'ba'cui'pi'yu'ding
辣子鱼块	la'zi'yu'kuai
辣子鸡丁	la'zi'ji'ding
辣子鸡	la'zi'ji
辣椒仔	la'jiao'zai
辣椒橙	la'jiao'cheng
辣椒汁	la'jiao'zhi
辣椒油树脂	la'jiao'you'shu'zhi
辣椒泡鱼	la'jiao'pao'yu
辣椒炒猪肚片	la'jiao'chao'zhu'du'pian
辣椒炒肚片	la'jiao'chao'du'pian
辣椒粉	la'jiao'fen
辣椒红	la'jiao'hong
辣椒蟹	la'jiao'xie
辣椒酱	la'jiao'jiang
辣椒鱼	la'jiao'yu
辣汁泥肠	la'zhi'ni'chang
辣汁茄丝	la'zhi'qie'si
辣汁酱香肘	la'zhi'jiang'xiang'zhou
辣油里脊丝	la'you'li'ji'si
辣炒猪肉豆腐	la'chao'zhu'rou'dou'fu
辣炒鱿鱼丝	la'chao'you'yu'si
辣白菜	la'bai'cai
辣豆瓣鱼	la'dou'ban'yu
辣豉香兔	la'chi'xiang'tu
边家辣肉丝罐头	bian'jia'la'rou'si'guan'tou
辽宁省	liao'ning'sheng
辽牛	liao'niu
辽阳塔糖	liao'yang'ta'tang
达仁堂	da'ren'tang
达瓦	da'wa
过桥米线	guo'qiao'mi'xian
过氧化氢	guo'yang'hua'qing
过氧化苯甲酰	guo'yang'hua'ben'jia'xian
过氧化钙	guo'yang'hua'gai
过油肉	guo'you'rou
运城南式细点	yun'cheng'nan'shi'xi'dian
还童茶	huan'tong'cha
进口鲍汁海螺片	jin'kou'bao'zhi'hai'luo'pian
进士糕和状元饼	jin'shi'gao'he'zhuang'yuan'bing
远香客食品	yuan'xiang'ke'shi'pin
连城地瓜干	lian'cheng'di'gua'gan
连环酥	lian'huan'su
连理双味鱼	lian'li'shuang'wei'yu
连锅汤	lian'guo'tang
连雾	lian'wu
迪凯堡	di'kai'bao
迷你天鵝泡芙	mi'ni'tian'e'pao'fu
迷迭香叶	mi'die'xiang'ye
迷迭香提取物	mi'die'xiang'ti'qu'wu
迷迭香粉	mi'die'xiang'fen
追风虎骨酒	zhui'feng'hu'gu'jiu
逍遥白玉瓜	xiao'yao'bai'yu'gua
通三益秋梨膏	tong'san'yi'qiu'li'gao
通心粉	tong'xin'fen
通海豆末糖	tong'hai'dou'mo'tang
通草排骨汤	tong'cao'pai'gu'tang
通草炖猪脚	tong'cao'dun'zhu'jiao
通草鲫鱼汤	tong'cao'ji'yu'tang
速客	su'ke
速溶咖啡	su'rong'ka'fei
速溶茶	su'rong'cha
遂川狗牯脑	sui'chuan'gou'gu'nao
道口烧鸡罐头	dao'kou'shao'ji'guan'tou
道酒	dao'jiu
遵义毛峰	zun'yi'mao'feng
遵义鸡蛋糕	zun'yi'ji'dan'gao
避风塘芋夹	bi'feng'tang'yu'jia
避风塘金蒜炒蟹	bi'feng'tang'jin'suan'chao'xie
那不勒斯咖啡	na'bu'le'si'ka'fei
那不勒斯风味咖啡	na'bu'le'si'feng'wei'ka'fei
邵阳广桃酥	shao'yang'guang'tao'su
邻氨基苯甲酸甲酯	lin'an'ji'ben'jia'suan'jia'zhi
邻苯基苯酚	lin'ben'ji'ben'fen
郁滋客来	yu'zi'ke'lai
都匀毛尖	du'yun'mao'jian
都督烧麦	du'du'shao'mai
鄣公山茶	zhang'gong'shan'cha
酒心巧克力	jiu'xin'qiao'ke'li
酒烹海螺	jiu'peng'hai'luo
酒石酸氢胆碱	jiu'shi'suan'qing'dan'jian
酒石酸氢钾	jiu'shi'suan'qing'jia
酒石酸	jiu'shi'suan
酒精饮料	jiu'jing'yin'liao
酒肠	jiu'chang
酒酿斑鸠	jiu'niang'ban'jiu
酒酿金腿	jiu'niang'jin'tui
酒酿鸽蛋	jiu'niang'ge'dan
酒醋汁	jiu'cu'zhi
酒香椒盐肘子	jiu'xiang'jiao'yan'zhou'zi
酥合和羊角蜜	su'he'he'yang'jiao'mi
酥小鲫鱼	su'xiao'ji'yu
酥性饼干	su'xing'bing'gan
酥炸嫩鸡	su'zha'nen'ji
酥炸排骨	su'zha'pai'gu
酥炸春花肉	su'zha'chun'hua'rou
酥炸牛柳	su'zha'niu'liu
酥炸牛肉卷	su'zha'niu'rou'juan
酥炸禾花雀	su'zha'he'hua'que
酥炸芝麻鱼	su'zha'zhi'ma'yu
酥炸茄盒	su'zha'qie'he
酥炸鸭子	su'zha'ya'zi
酥烂蹄筋	su'lan'ti'jin
酥皮月饼	su'pi'yue'bing
酥皮芋蓉盅	su'pi'yu'rong'zhong
酥皮鸡饺	su'pi'ji'jiao
酥皮麻饼	su'pi'ma'bing
酥皮龙虾	su'pi'long'xia
酥盐鸡块	su'yan'ji'kuai
酥盒回锅肉	su'he'hui'guo'rou
酥盒子	su'he'zi
酥蜜鲜果夹	su'mi'xian'guo'jia
酪蛋白磷酸肽	lao'dan'bai'lin'suan'tai
酪蛋白钙肽	lao'dan'bai'gai'tai
酱核桃	jiang'he'tao
酱椒鱼头	jiang'jiao'yu'tou
酱汁排骨	jiang'zhi'pai'gu
酱汁顺风糕	jiang'zhi'shun'feng'gao
酱汁鸭方	jiang'zhi'ya'fang
酱油嫩鸡	jiang'you'nen'ji
酱油曲营养饮料	jiang'you'qu'ying'yang'yin'liao
酱油	jiang'you
酱炒萝卜糕	jiang'chao'luo'bo'gao
酱炒鸡翼球	jiang'chao'ji'yi'qiu
酱烧冬瓜条	jiang'shao'dong'gua'tiao
酱烧茄子	jiang'shao'qie'zi
酱烧茄	jiang'shao'qie
酱烧茭白	jiang'shao'jiao'bai
酱爆牛肉	jiang'bao'niu'rou
酱爆肉酥饼	jiang'bao'rou'su'bing
酱爆肉	jiang'bao'rou
酱爆青蟹	jiang'bao'qing'xie
酱爆鸭块	jiang'bao'ya'kuai
酱瓜炒肉丝	jiang'gua'chao'rou'si
酱粉丝菠菜	jiang'fen'si'bo'cai
酱羊肉	jiang'yang'rou
酱肉丝	jiang'rou'si
酱蜜汁烤鸭脯	jiang'mi'zhi'kao'ya'pu
酱豆腐肉	jiang'dou'fu'rou
酱酥桃仁	jiang'su'tao'ren
酱鸡	jiang'ji
酱黄瓜	jiang'huang'gua
酶制剂	mei'zhi'ji
酶处理异槲皮苷	mei'chu'li'yi'hu'pi'gan
酷梨	ku'li
酷蛋白酸钠	ku'dan'bai'suan'na
酸奶低糖蛋糕	suan'nai'di'tang'dan'gao
酸奶慕丝蛋糕	suan'nai'mu'si'dan'gao
酸奶戚风	suan'nai'qi'feng
酸奶芝士蛋糕	suan'nai'zhi'shi'dan'gao
酸度调节剂	suan'du'tiao'jie'ji
酸性红	suan'xing'hong
酸枣仁枸杞茶	suan'zao'ren'gou'qi'cha
酸枣汁汽水	suan'zao'zhi'qi'shui
酸枣色	suan'zao'se
酸枣露	suan'zao'lu
酸梅汤	suan'mei'tang
酸橙	suan'cheng
酸汤米线	suan'tang'mi'xian
酸汤饵丝	suan'tang'er'si
酸汤龙骨面	suan'tang'long'gu'mian
酸牛乳	suan'niu'ru
酸腌菜炒藕	suan'yan'cai'chao'ou
酸莓	suan'mei
酸菜小豆汤	suan'cai'xiao'dou'tang
酸菜梅鱼	suan'cai'mei'yu
酸菜火锅	suan'cai'huo'guo
酸菜煮鱼	suan'cai'zhu'yu
酸菜牛肉丸子	suan'cai'niu'rou'wan'zi
酸菜牛肉	suan'cai'niu'rou
酸菜牛	suan'cai'niu
酸菜藕片	suan'cai'ou'pian
酸菜鱼	suan'cai'yu
酸菜鱿鱼	suan'cai'you'yu
酸蘑罐头	suan'mo'guan'tou
酸豆角炒肉末	suan'dou'jiao'chao'rou'mo
酸豆	suan'dou
酸辣凤爪	suan'la'feng'zhao
酸辣土豆丝	suan'la'tu'dou'si
酸辣汤	suan'la'tang
酸辣海参锅巴	suan'la'hai'shen'guo'ba
酸辣狗肉	suan'la'gou'rou
酸辣瓜片	suan'la'gua'pian
酸辣白菜	suan'la'bai'cai
酸辣粉	suan'la'fen
酸辣肘子	suan'la'zhou'zi
酸辣臊子蹄筋	suan'la'sao'zi'ti'jin
酸辣蹄筋	suan'la'ti'jin
酸辣青蚝	suan'la'qing'hao
酸辣鱼	suan'la'yu
酸辣鱿鱼丝	suan'la'you'yu'si
酸辣鸡丁	suan'la'ji'ding
酿倭瓜	niang'wo'gua
酿冬瓜	niang'dong'gua
酿山药	niang'shan'yao
酿枇杷	niang'pi'pa
酿海参	niang'hai'shen
酿青椒	niang'qing'jiao
醉大转弯	zui'da'zhuan'wan
醉排骨	zui'pai'gu
醉活虾	zui'huo'xia
醉蚌肉	zui'bang'rou
醉蟹清炖鸡	zui'xie'qing'dun'ji
醉酒的天使蛋糕	zui'jiu'de'tian'shi'dan'gao
醉鸡翅	zui'ji'chi
醉鹅掌	zui'e'zhang
醋拌莲藕	cu'ban'lian'ou
醋椒桂鱼	cu'jiao'gui'yu
醋椒活鱼	cu'jiao'huo'yu
醋溜白菜	cu'liu'bai'cai
醋溜藕片	cu'liu'ou'pian
醋溜黄瓜	cu'liu'huang'gua
醋熘鳜鱼	cu'liu'gui'yu
醋粟	cu'su
醋辣白菜梗	cu'la'bai'cai'geng
醪糟罐头	lao'zao'guan'tou
醪糟鸡蛋	lao'zao'ji'dan
醪糟麻花	lao'zao'ma'hua
采芝斋糖果	cai'zhi'zhai'tang'guo
释迦	shi'jia
里叶白莲	li'ye'bai'lian
重庆糖衣炮弹	chong'qing'tang'yi'pao'dan
重庆芝麻片	chong'qing'zhi'ma'pian
重阳糕	chong'yang'gao
重阳花糕	chong'yang'hua'gao
野太阳	ye'tai'yang
野山椒河蚌炖猪脚	ye'shan'jiao'he'bang'dun'zhu'jiao
野无花果	ye'wu'hua'guo
野生大鱼坊	ye'sheng'da'yu'fang
野生菌汤	ye'sheng'jun'tang
野生酸枣汁	ye'sheng'suan'zao'zhi
野葱炒牛肉	ye'cong'chao'niu'rou
野鸭菜饭	ye'ya'cai'fan
金万利香橙白兰地咖啡	jin'wan'li'xiang'cheng'bai'lan'di'ka'fei
金万利香橙酒	jin'wan'li'xiang'cheng'jiu
金丝海蟹	jin'si'hai'xie
金丝烧麦	jin'si'shao'mai
金丝玉兔	jin'si'yu'tu
金丝琥珀蜜枣	jin'si'hu'po'mi'zao
金丝蜜枣	jin'si'mi'zao
金丝饼	jin'si'bing
金元宝	jin'yuan'bao
金包银	jin'bao'yin
金华五仁月饼	jin'hua'wu'ren'yue'bing
金华玉树鸡	jin'hua'yu'shu'ji
金叶奶油蛋糕	jin'ye'nai'you'dan'gao
金塘李蜜饯	jin'tang'li'mi'jian
金奖惠明茶	jin'jiang'hui'ming'cha
金威啤酒	jin'wei'pi'jiu
金屋藏娇	jin'wu'cang'jiao
金山时雨茶	jin'shan'shi'yu'cha
金岗银针茶	jin'gang'yin'zhen'cha
金巴利	jin'ba'li
金德啤酒	jin'de'pi'jiu
金星啤酒	jin'xing'pi'jiu
金杏	jin'xing
金枣烧排骨	jin'zao'shao'pai'gu
金枪鱼三文治	jin'qiang'yu'san'wen'zhi
金枪鱼面包	jin'qiang'yu'mian'bao
金枪鱼	jin'qiang'yu
金桂花茶饼	jin'gui'hua'cha'bing
金桔丝	jin'ju'si
金桔花	jin'ju'hua
金桔	jin'ju
金桥腐竹	jin'qiao'fu'zhu
金樱子棕	jin'ying'zi'zong
金汉斯烤肉	jin'han'si'kao'rou
金沙土豆泥	jin'sha'tu'dou'ni
金溪藕丝糖	jin'xi'ou'si'tang
金澳	jin'ao
金牌叉烧酥	jin'pai'cha'shao'su
金牌手撕鸭	jin'pai'shou'si'ya
金牌猪手王	jin'pai'zhu'shou'wang
金牌胡萝卜	jin'pai'hu'luo'bo
金牌蒜香骨	jin'pai'suan'xiang'gu
金牛牌奶油蛋卷	jin'niu'pai'nai'you'dan'juan
金牛鸭子	jin'niu'ya'zi
金狮奶糖	jin'shi'nai'tang
金狮绣球	jin'shi'xiu'qiu
金玉满堂	jin'yu'man'tang
金盏松茸	jin'zhan'song'rong
金秋之梨	jin'qiu'zhi'li
金种子	jin'zhong'zi
金粟棒棒鱼饼	jin'su'bang'bang'yu'bing
金糕卷	jin'gao'juan
金糕	jin'gao
金绿罐礼盒	jin'lv'guan'li'he
金腿脊梅炖腰酥	jin'tui'ji'mei'dun'yao'su
金腿鲫鱼	jin'tui'ji'yu
金色咖啡茶	jin'se'ka'fei'cha
金菊	jin'ju
金蟾拜月	jin'chan'bai'yue
金诺	jin'nuo
金酒	jin'jiu
金针粉丝煮	jin'zhen'fen'si'zhu
金针菇冬笋	jin'zhen'gu'dong'sun
金针菇罐头	jin'zhen'gu'guan'tou
金针菇	jin'zhen'gu
金针豆腐	jin'zhen'dou'fu
金钩挂玉牌	jin'gou'gua'yu'pai
金钩蛋卷	jin'gou'dan'juan
金钩青菜心	jin'gou'qing'cai'xin
金钱口蘑汤	jin'qian'kou'mo'tang
金钱吐丝	jin'qian'tu'si
金钱干贝	jin'qian'gan'bei
金钱洋芋饼	jin'qian'yang'yu'bing
金钱海参	jin'qian'hai'shen
金钱牛排	jin'qian'niu'pai
金钱肉	jin'qian'rou
金钱芝麻虾	jin'qian'zhi'ma'xia
金钱草粥	jin'qian'cao'zhou
金钱香菇	jin'qian'xiang'gu
金钱鱼肚	jin'qian'yu'du
金钱鸡卷	jin'qian'ji'juan
金钱鸡塔	jin'qian'ji'ta
金钻甜奶油	jin'zuan'tian'nai'you
金银枣	jin'yin'zao
金银蹄	jin'yin'ti
金锣大红肠	jin'luo'da'hong'chang
金锣宝肚	jin'luo'bao'du
金锣火腿肠	jin'luo'huo'tui'chang
金镶玉板	jin'xiang'yu'ban
金镶玉菠菜汤	jin'xiang'yu'bo'cai'tang
金雀舌	jin'que'she
金鱼戏莲	jin'yu'xi'lian
金鱼鸭掌	jin'yu'ya'zhang
金鸡独立	jin'ji'du'li
金黄蜜枣	jin'huang'mi'zao
鑫鼎	xin'ding
钠盐酚	na'yan'fen
钱江鲈鱼	qian'jiang'lu'yu
钱钱饭	qian'qian'fan
钵钵鸡	bo'bo'ji
钾明矾硫酸铝铵	jia'ming'fan'liu'suan'lv'an
铁扒仔鸡	tie'ba'zi'ji
铁板腐皮鸭	tie'ban'fu'pi'ya
铁板蚝油栗子鸡	tie'ban'hao'you'li'zi'ji
铁板鱿鱼须	tie'ban'you'yu'xu
铁板鱿鱼	tie'ban'you'yu
铁板黑椒牛柳	tie'ban'hei'jiao'niu'liu
铁狮子头	tie'shi'zi'tou
铁观音	tie'guan'yin
铁锅蛋	tie'guo'dan
铜锣烧	tong'luo'shao
铝胶	lv'jiao
铭雄明	ming'xiong'ming
铵磷脂	an'lin'zhi
银丝酥	yin'si'su
银包金	yin'bao'jin
银杏芋泥	yin'xing'yu'ni
银杏蒸鸭	yin'xing'zheng'ya
银杞明目汤	yin'qi'ming'mu'tang
银梅口乐	yin'mei'kou'le
银牙韭菜花	yin'ya'jiu'cai'hua
银耳保健饮料	yin'er'bao'jian'yin'liao
银耳川鸭	yin'er'chuan'ya
银耳杏仁百合汤	yin'er'xing'ren'bai'he'tang
银耳氽鸡片	yin'er'tun'ji'pian
银耳汽锅鸡	yin'er'qi'guo'ji
银耳海参汤	yin'er'hai'shen'tang
银耳雪梨炖瘦肉	yin'er'xue'li'dun'shou'rou
银耳香菇鸡肉汤	yin'er'xiang'gu'ji'rou'tang
银花薄荷饮	yin'hua'bo'he'yin
银芽韭菜花	yin'ya'jiu'cai'hua
银芽鸡丝	yin'ya'ji'si
银鱼干	yin'yu'gan
银鱼柳	yin'yu'liu
银鱼稀卤豆花	yin'yu'xi'lu'dou'hua
银鱼藕丝	yin'yu'ou'si
银鱼	yin'yu
银鳕鱼	yin'xue'yu
链条鱼	lian'tiao'yu
锅包肉	guo'bao'rou
锅塌多维豆腐	guo'ta'duo'wei'dou'fu
锅塌茄盒	guo'ta'qie'he
锅塌菠菜	guo'ta'bo'cai
锅塌蒲菜	guo'ta'pu'cai
锅塌豆腐	guo'ta'dou'fu
锅塌鸡片	guo'ta'ji'pian
锅塌鸡签	guo'ta'ji'qian
锅塌黄鱼	guo'ta'huang'yu
锅巴三鲜	guo'ba'san'xian
锅巴肉片	guo'ba'rou'pian
锅榻腰盒	guo'ta'yao'he
锅烧海参	guo'shao'hai'shen
锅烧猪蹄儿	guo'shao'zhu'ti'er
锅烧白菜	guo'shao'bai'cai
锅烧肘子	guo'shao'zhou'zi
锅烧野鸭	guo'shao'ye'ya
锅烧鲤鱼	guo'shao'li'yu
锅烧鳗	guo'shao'man
锅烧鸡	guo'shao'ji
锅烧鸭	guo'shao'ya
锅煸豆腐	guo'bian'dou'fu
锅煽豆腐	guo'shan'dou'fu
锅熠银鱼	guo'yi'yin'yu
锅盔馍	guo'kui'mo
锅贴石斑夹	guo'tie'shi'ban'jia
锅贴饺	guo'tie'jiao
锅贴鱼片	guo'tie'yu'pian
锅贴鱼	guo'tie'yu
锅贴鸡片	guo'tie'ji'pian
锅贴鸭方	guo'tie'ya'fang
锅贴	guo'tie
锅酥牛肉	guo'su'niu'rou
锥栗罐头	zhui'li'guan'tou
锥栗	zhui'li
锦珍叉烧酱	jin'zhen'cha'shao'jiang
锦珍柱候酱	jin'zhen'zhu'hou'jiang
锦珍海鲜酱	jin'zhen'hai'xian'jiang
锦珍豆瓣酱	jin'zhen'dou'ban'jiang
锦绣时菜塔	jin'xiu'shi'cai'ta
锦绣鱼丝	jin'xiu'yu'si
镜糕	jing'gao
镶碗	xiang'wan
长圆糕	chang'yuan'gao
长城干白葡萄酒	chang'cheng'gan'bai'pu'tao'jiu
长城	chang'cheng
长安大麯	chang'an'da'qu
长安柿酒	chang'an'shi'jiu
长寿糕	chang'shou'gao
长寿薄脆	chang'shou'bao'cui
长岛海鲜罐头	chang'dao'hai'xian'guan'tou
长崎蜂蜜蛋糕	chang'qi'feng'mi'dan'gao
长武锅盔	chang'wu'guo'kui
长江月饼	chang'jiang'yue'bing
长治山楂饼	chang'zhi'shan'zha'bing
门钉肉饼	men'ding'rou'bing
问荆茶	wen'jing'cha
闷炉烧饼	men'lu'shao'bing
闻喜煮饼	wen'xi'zhu'bing
闽北花生酥	min'bei'hua'sheng'su
闽生果	min'sheng'guo
闽菜	min'cai
阜宁大糕	fu'ning'da'gao
防腐剂	fang'fu'ji
阳光地带	yang'guang'di'dai
阳高杏脯	yang'gao'xing'fu
阿拉伯咖啡	a'la'bo'ka'fei
阿拉伯胶	a'la'bo'jiao
阿斯巴甜	a'si'ba'tian
阿美菲比萨	a'mei'fei'bi'sa
阿胶养阴粥	e'jiao'yang'yin'zhou
阿胶炖肉	e'jiao'dun'rou
阿胶牛肉汤	e'jiao'niu'rou'tang
阿里山高山茶	a'li'shan'gao'shan'cha
陆家浜糖枣	lu'jia'bang'tang'zao
陆稿荐卤肉	lu'gao'jian'lu'rou
陆良馓子	lu'liang'san'zi
陇县马蹄酥	long'xian'ma'ti'su
陈年菜脯鸡	chen'nian'cai'pu'ji
陈村枧水	chen'cun'jian'shui
陈皮爆河虾	chen'pi'bao'he'xia
陈皮牛肉	chen'pi'niu'rou
陈皮红枣茶	chen'pi'hong'zao'cha
陈皮车前减肥茶	chen'pi'che'qian'jian'fei'cha
陈醋焖咸蛋	chen'cu'men'xian'dan
降压决明粥	jiang'ya'jue'ming'zhou
降压清热海带汤	jiang'ya'qing're'hai'dai'tang
降红木素	jiang'hong'mu'su
降脂益寿茶	jiang'zhi'yi'shou'cha
陶然居	tao'ran'ju
陶陶居上月	tao'tao'ju'shang'yue
隆鑫	long'xin
隋王府系列	sui'wang'fu'xi'lie
雀巢冰咖啡	que'chao'bing'ka'fei
雀巢奶油蛋糕	que'chao'nai'you'dan'gao
雀巢淡奶油	que'chao'dan'nai'you
雀巢燕麦饼干	que'chao'yan'mai'bing'gan
雀巢黑椒牛柳	que'chao'hei'jiao'niu'liu
雁荡毛峰茶	yan'dang'mao'feng'cha
雁荡白云茶	yan'dang'bai'yun'cha
雅丽嘉	ya'li'jia
雅洁	ya'jie
雅诗轩	ya'shi'xuan
集贤里	ji'xian'li
雨后春笋	yu'hou'chun'sun
雪地红莲	xue'di'hong'lian
雪山潭虾	xue'shan'tan'xia
雪山蛋糕	xue'shan'dan'gao
雪布卷蛋糕	xue'bu'juan'dan'gao
雪映红梅	xue'ying'hong'mei
雪月羊肉	xue'yue'yang'rou
雪梨兔肉羹	xue'li'tu'rou'geng
雪梨木瓜炖冰糖	xue'li'mu'gua'dun'bing'tang
雪梨炖燕窝	xue'li'dun'yan'wo
雪梨猪踭汤	xue'li'zhu'zheng'tang
雪梨肘棒	xue'li'zhou'bang
雪梨酒	xue'li'jiu
雪梨	xue'li
雪绵豆沙	xue'mian'dou'sha
雪耳冬菇猪胰汤	xue'er'dong'gu'zhu'yi'tang
雪耳炖白鸽	xue'er'dun'bai'ge
雪花桃泥	xue'hua'tao'ni
雪花豆腐羹	xue'hua'dou'fu'geng
雪花鱼翅	xue'hua'yu'chi
雪花鱼肚	xue'hua'yu'du
雪花鸡汤	xue'hua'ji'tang
雪花鸡淖	xue'hua'ji'nao
雪菜大汤黄鱼	xue'cai'da'tang'huang'yu
雪菜肉丝	xue'cai'rou'si
雪蛋	xue'dan
雪衣红沙	xue'yi'hong'sha
雪里藏珠	xue'li'cang'zhu
雪霜面包	xue'shuang'mian'bao
雪顶咖啡	xue'ding'ka'fei
雪魔芋鸡翅	xue'mo'yu'ji'chi
零点咖啡	ling'dian'ka'fei
雷公山天麻	lei'gong'shan'tian'ma
雾洞茶	wu'dong'cha
雾熘桂鱼	wu'liu'gui'yu
震远同玫瑰酥糖	zhen'yuan'tong'mei'gui'su'tang
露丝	lu'si
霸王别姬	ba'wang'bie'ji
霸王鸡翅	ba'wang'ji'chi
青制啤酒	qing'zhi'pi'jiu
青城苦丁茶	qing'cheng'ku'ding'cha
青城茶	qing'cheng'cha
青岛纯生	qing'dao'chun'sheng
青岛高粱饴	qing'dao'gao'liang'yi
青岛	qing'dao
青岩茗翠	qing'yan'ming'cui
青木瓜	qing'mu'gua
青果	qing'guo
青梅	qing'mei
青椒南瓜	qing'jiao'nan'gua
青椒塞肉	qing'jiao'sai'rou
青椒木耳蛋	qing'jiao'mu'er'dan
青椒炒子鸡	qing'jiao'chao'zi'ji
青椒牛肉丝	qing'jiao'niu'rou'si
青椒茄泥	qing'jiao'qie'ni
青椒豇豆	qing'jiao'jiang'dou
青椒	qing'jiao
青芥末	qing'jie'mo
青芥辣	qing'jie'la
青茶	qing'cha
青菜肉丸汤	qing'cai'rou'wan'tang
青菠面	qing'bo'mian
青萝卜陈皮煲鸭汤	qing'luo'bo'chen'pi'bao'ya'tang
青蒜炒腊肉	qing'suan'chao'la'rou
青蒜鲤鱼汤	qing'suan'li'yu'tang
青蛋糕	qing'dan'gao
青蟹粉丝煲	qing'xie'fen'si'bao
青豆牛肉末	qing'dou'niu'rou'mo
青韭鱿鱼丝	qing'jiu'you'yu'si
靖县蜜饯	jing'xian'mi'jian
靛蓝铝色淀	dian'lan'lv'se'dian
靛蓝	dian'lan
非常可乐	fei'chang'ke'le
非常男士	fei'chang'nan'shi
面包改良剂	mian'bao'gai'liang'ji
面包环	mian'bao'huan
面包糠	mian'bao'kang
面包酥	mian'bao'su
面皮	mian'pi
面筋萨其玛	mian'jin'sa'qi'ma
面粉处理剂	mian'fen'chu'li'ji
面粉改良剂	mian'fen'gai'liang'ji
面茶	mian'cha
面鲜	mian'xian
韧性饼干	ren'xing'bing'gan
韩包子	han'bao'zi
韩城羊肉饸饹	han'cheng'yang'rou'he'le
韩式烤鱿鱼	han'shi'kao'you'yu
韩式辣酱鱿鱼丝	han'shi'la'jiang'you'yu'si
韭菜丝墨鱼汤	jiu'cai'si'mo'yu'tang
韭菜包子	jiu'cai'bao'zi
韭菜包	jiu'cai'bao
韭菜墨鱼丝	jiu'cai'mo'yu'si
韭菜炒绿豆芽	jiu'cai'chao'lv'dou'ya
韭菜炒肉	jiu'cai'chao'rou
韭菜炒黄鳝	jiu'cai'chao'huang'shan
韭菜肉片汤	jiu'cai'rou'pian'tang
韭菜花	jiu'cai'hua
韭菜苹果汁	jiu'cai'ping'guo'zhi
韭菜豆渣饼	jiu'cai'dou'zha'bing
韭菜鲜鱿	jiu'cai'xian'you
韭黄肉丝	jiu'huang'rou'si
顶呱呱	ding'gua'gua
顶级贝利尼	ding'ji'bei'li'ni
顶雪贡糕	ding'xue'gong'gao
顾渚紫笋茶	gu'zhu'zi'sun'cha
风味南美螺	feng'wei'nan'mei'luo
风味羊腿	feng'wei'yang'tui
风味腊肠卷	feng'wei'la'chang'juan
风庆粑粑卷	feng'qing'ba'ba'juan
风情羊柳	feng'qing'yang'liu
风林茄子	feng'lin'qie'zi
风炖牡丹	feng'dun'mu'dan
风车酥	feng'che'su
风鸡斩肉	feng'ji'zhan'rou
飘仙一号	piao'xian'yi'hao
飘香蛋挞	piao'xiang'dan'ta
食品香料	shi'pin'xiang'liao
食嘉益	shi'jia'yi
食珍桔红糕	shi'zhen'ju'hong'gao
餐包	can'bao
饮养源	yin'yang'yuan
饮料罐头	yin'liao'guan'tou
饮用水	yin'yong'shui
饵丝	er'si
饵块	er'kuai
饺子宴	jiao'zi'yan
馄饨千层饼	hun'tun'qian'ceng'bing
馄饨香蕉卷	hun'tun'xiang'jiao'juan
馄饨鸭子	hun'tun'ya'zi
馄饨	hun'tun
馏鱼片	liu'yu'pian
馓子麻花	san'zi'ma'hua
馕包肉	nang'bao'rou
馕坑肉	nang'keng'rou
首乌肝片	shou'wu'gan'pian
香兰素	xiang'lan'su
香厚壳桂皮油	xiang'hou'ke'gui'pi'you
香叶油	xiang'ye'you
香叶醇	xiang'ye'chun
香天液	xiang'tian'ye
香德利	xiang'de'li
香椿白肉丝	xiang'chun'bai'rou'si
香槟酒	xiang'bin'jiu
香橙果茶蛋糕	xiang'cheng'guo'cha'dan'gao
香橙糕	xiang'cheng'gao
香橙蓝莓蛋糕	xiang'cheng'lan'mei'dan'gao
香油石鳞	xiang'you'shi'lin
香油米花糖	xiang'you'mi'hua'tang
香浓芝士球	xiang'nong'zhi'shi'qiu
香滑椰汁糕	xiang'hua'ye'zhi'gao
香滑鲈鱼球	xiang'hua'lu'yu'qiu
香炸云雾	xiang'zha'yun'wu
香炸螺丝卷	xiang'zha'luo'si'juan
香炸金片	xiang'zha'jin'pian
香炸雪梨	xiang'zha'xue'li
香炸龙凤蛋	xiang'zha'long'feng'dan
香煎南瓜饼	xiang'jian'nan'gua'bing
香煎土豆饼	xiang'jian'tu'dou'bing
香煎牛仔骨	xiang'jian'niu'zai'gu
香煎翘鱼	xiang'jian'qiao'yu
香煎苹果薯饼	xiang'jian'ping'guo'shu'bing
香煎茄片	xiang'jian'qie'pian
香煎莲藕饼	xiang'jian'lian'ou'bing
香煎菜脯蛋	xiang'jian'cai'pu'dan
香煎萨拉米土豆饼	xiang'jian'sa'la'mi'tu'dou'bing
香煎韭菜盒	xiang'jian'jiu'cai'he
香片辫子包	xiang'pian'bian'zi'bao
香甜酒	xiang'tian'jiu
香米热狗	xiang'mi're'gou
香粽烧排骨	xiang'zong'shao'pai'gu
香肠儿	xiang'chang'er
香肠油菜	xiang'chang'you'cai
香肠炒油菜	xiang'chang'chao'you'cai
香肠烧菜花	xiang'chang'shao'cai'hua
香肠芥兰	xiang'chang'jie'lan
香脂醋风味烤鸡	xiang'zhi'cu'feng'wei'kao'ji
香脆果饼	xiang'cui'guo'bing
香脆苹果虾仁	xiang'cui'ping'guo'xia'ren
香脆锅巴	xiang'cui'guo'ba
香芋冰皮月饼	xiang'yu'bing'pi'yue'bing
香芋扣肉	xiang'yu'kou'rou
香芋油鸭煲	xiang'yu'you'ya'bao
香芋蛋糕	xiang'yu'dan'gao
香芒心太软	xiang'mang'xin'tai'ruan
香芹片	xiang'qin'pian
香芹籽	xiang'qin'zi
香芹酮	xiang'qin'tong
香茅醇	xiang'mao'chun
香茅醛	xiang'mao'quan
香草绿豆糕	xiang'cao'lv'dou'gao
香草蛋挞	xiang'cao'dan'ta
香草蛋糕	xiang'cao'dan'gao
香草鲑鱼薯仔饼	xiang'cao'gui'yu'shu'zai'bing
香菇包子	xiang'gu'bao'zi
香菇包	xiang'gu'bao
香菇烧菜心	xiang'gu'shao'cai'xin
香菇素鸡	xiang'gu'su'ji
香菇肉酱罐头	xiang'gu'rou'jiang'guan'tou
香菇茭白汤	xiang'gu'jiao'bai'tang
香菇西兰花	xiang'gu'xi'lan'hua
香菇豆角	xiang'gu'dou'jiao
香菇醉鸡	xiang'gu'zui'ji
香菇风味香辛料	xiang'gu'feng'wei'xiang'xin'liao
香菇鱼片粥	xiang'gu'yu'pian'zhou
香菜籽粉	xiang'cai'zi'fen
香菜粉	xiang'cai'fen
香菠血糯饭	xiang'bo'xue'nuo'fan
香葱炒大肠	xiang'cong'chao'da'chang
香葱炒豌豆	xiang'cong'chao'wan'dou
香葱煎酿豆腐	xiang'cong'jian'niang'dou'fu
香葱芝麻饼	xiang'cong'zhi'ma'bing
香葱苏打饼干	xiang'cong'su'da'bing'gan
香蒜咖喱炒蟹	xiang'suan'ga'li'chao'xie
香蕉冰糖汤	xiang'jiao'bing'tang'tang
香蕉果炸	xiang'jiao'guo'zha
香蕉果粒玛芬	xiang'jiao'guo'li'ma'fen
香蕉核桃饼干	xiang'jiao'he'tao'bing'gan
香蕉治燥咳糖水	xiang'jiao'zhi'zao'ke'tang'shui
香蕉粥	xiang'jiao'zhou
香蕉肉脯	xiang'jiao'rou'pu
香蕉船	xiang'jiao'chuan
香蕉芝士蛋糕	xiang'jiao'zhi'shi'dan'gao
香蕉蛋奶饼	xiang'jiao'dan'nai'bing
香蕉蛋糕	xiang'jiao'dan'gao
香蕉西米羹	xiang'jiao'xi'mi'geng
香蕉软糖	xiang'jiao'ruan'tang
香蕉酥	xiang'jiao'su
香蕉锅炸	xiang'jiao'guo'zha
香蜂草	xiang'feng'cao
香软鹅肝糕	xiang'ruan'e'gan'gao
香辣乡村小炒鸡	xiang'la'xiang'cun'xiao'chao'ji
香辣卤笋	xiang'la'lu'sun
香辣咖哩面包	xiang'la'ka'li'mian'bao
香辣毛豆	xiang'la'mao'dou
香辣滷鸡心	xiang'la'lu'ji'xin
香辣炒蟹	xiang'la'chao'xie
香辣盆盆虾	xiang'la'pen'pen'xia
香辣粉蒸肉	xiang'la'fen'zheng'rou
香辣肉丝	xiang'la'rou'si
香辣脆皮明虾	xiang'la'cui'pi'ming'xia
香辣腌制料	xiang'la'yan'zhi'liao
香辣虾	xiang'la'xia
香辣蹄花	xiang'la'ti'hua
香辣鸡	xiang'la'ji
香迪啤酒	xiang'di'pi'jiu
香酥丹麦曲奇	xiang'su'dan'mai'qu'qi
香酥全鸡和烤全鸭罐头	xiang'su'quan'ji'he'kao'quan'ya'guan'tou
香酥凤腿	xiang'su'feng'tui
香酥填鸭	xiang'su'tian'ya
香酥山药	xiang'su'shan'yao
香酥牛柳卷	xiang'su'niu'liu'juan
香酥竹荪鱼	xiang'su'zhu'sun'yu
香酥米糖	xiang'su'mi'tang
香酥糕	xiang'su'gao
香酥素鸭块	xiang'su'su'ya'kuai
香酥羊排	xiang'su'yang'pai
香酥肉片起司	xiang'su'rou'pian'qi'si
香酥蛋塔盅	xiang'su'dan'ta'zhong
香酥蛋挞	xiang'su'dan'ta
香酥饼	xiang'su'bing
香酥香蕉卷	xiang'su'xiang'jiao'juan
香酥鸡	xiang'su'ji
香酥鸭	xiang'su'ya
香醋猪手	xiang'cu'zhu'shou
香附茶	xiang'fu'cha
香附豆腐汤	xiang'fu'dou'fu'tang
香露苹果	xiang'lu'ping'guo
香飘飘	xiang'piao'piao
香鱼白菜	xiang'yu'bai'cai
馨华	xin'hua
馨意数码蛋糕	xin'yi'shu'ma'dan'gao
马可波罗	ma'ke'bo'luo
马奶子酒	ma'nai'zi'jiu
马奶酒	ma'nai'jiu
马提尼	ma'ti'ni
马牙肉	ma'ya'rou
马苏里拉	ma'su'li'la
马谛氏	ma'di'shi
马蹄爽糕	ma'ti'shuang'gao
马蹄蛋糕	ma'ti'dan'gao
马蹄豆腐汤	ma'ti'dou'fu'tang
马蹄酥	ma'ti'su
马蹄鸡丁	ma'ti'ji'ding
马铃薯笋焖鸡	ma'ling'shu'sun'men'ji
驭手咖啡	yu'shou'ka'fei
驴打滚	lv'da'gun
驴肉	lv'rou
驼峰	tuo'feng
骨头汤米线	gu'tou'tang'mi'xian
骨头汤饵丝	gu'tou'tang'er'si
骨牛排	gu'niu'pai
骨痛药酒	gu'tong'yao'jiu
骨肉相连腌制料	gu'rou'xiang'lian'yan'zhi'liao
骨髓壮	gu'sui'zhuang
骨髓肝酱罐头	gu'sui'gan'jiang'guan'tou
高丽人参茶食礼盒	gao'li'ren'shen'cha'shi'li'he
高丽参碳酸饮	gao'li'shen'tan'suan'yin
高丽香蕉	gao'li'xiang'jiao
高丽鱼条	gao'li'yu'tiao
高倍果汁	gao'bei'guo'zhi
高力豆沙	gao'li'dou'sha
高原露	gao'yuan'lu
高圣草酚钠盐	gao'sheng'cao'fen'na'yan
高密蜜枣	gao'mi'mi'zao
高岭土	gao'ling'tu
高峰云雾茶	gao'feng'yun'wu'cha
高桥松饼	gao'qiao'song'bing
高桥银锋茶	gao'qiao'yin'feng'cha
高梁红	gao'liang'hong
高河菜	gao'he'cai
高碳醇脂肪酸酯复合物	gao'tan'chun'zhi'fang'suan'zhi'fu'he'wu
高粱米	gao'liang'mi
高粱饴糖	gao'liang'yi'tang
高糖樱桃罐头	gao'tang'ying'tao'guan'tou
高纤维椰果	gao'xian'wei'ye'guo
高维苏肠	gao'wei'su'chang
高邮董糖	gao'you'dong'tang
高钙糊塌子	gao'gai'hu'ta'zi
高锰酸钾	gao'meng'suan'jia
鬼马牛肉	gui'ma'niu'rou
魔力冰淇淋咖啡	mo'li'bing'qi'lin'ka'fei
魔芋糕	mo'yu'gao
魔芋锅巴炒肉丝	mo'yu'guo'ba'chao'rou'si
魔芋鸭块	mo'yu'ya'kuai
鮰鱼肚片	hui'yu'du'pian
鮰鱼鱼泡	hui'yu'yu'pao
鮰鱼鱼翅	hui'yu'yu'chi
鮰鱼鱼胃	hui'yu'yu'wei
鱼三味	yu'san'wei
鱼云酥	yu'yun'su
鱼咬羊	yu'yao'yang
鱼头火锅	yu'tou'huo'guo
鱼头豆腐汤	yu'tou'dou'fu'tang
鱼奶油盏	yu'nai'you'zhan
鱼汁	yu'zhi
鱼片蒸水蛋	yu'pian'zheng'shui'dan
鱼皮花生	yu'pi'hua'sheng
鱼米羹	yu'mi'geng
鱼罐头	yu'guan'tou
鱼羊炖时蔬	yu'yang'dun'shi'shu
鱼羊鲜	yu'yang'xian
鱼翅水晶包	yu'chi'shui'jing'bao
鱼肉丸香辛料	yu'rou'wan'xiang'xin'liao
鱼肉肠	yu'rou'chang
鱼胶圆肉炖水鸭	yu'jiao'yuan'rou'dun'shui'ya
鱼脯丸子	yu'pu'wan'zi
鱼腥草煲猪肺	yu'xing'cao'bao'zhu'fei
鱼腥草蒸鸡	yu'xing'cao'zheng'ji
鱼腩煲	yu'nan'bao
鱼花豆腐	yu'hua'dou'fu
鱼茸乳扇卷	yu'rong'ru'shan'juan
鱼香味	yu'xiang'wei
鱼香大虾	yu'xiang'da'xia
鱼香油菜苔	yu'xiang'you'cai'tai
鱼香炒蛋	yu'xiang'chao'dan
鱼香牛腩	yu'xiang'niu'nan
鱼香碎滑肉	yu'xiang'sui'hua'rou
鱼香肉丝	yu'xiang'rou'si
鱼香肉片	yu'xiang'rou'pian
鱼香腰花	yu'xiang'yao'hua
鱼香苦瓜	yu'xiang'ku'gua
鱼香茄子	yu'xiang'qie'zi
鱼香茄条	yu'xiang'qie'tiao
鱼香茄饼	yu'xiang'qie'bing
鱼香荷包蛋	yu'xiang'he'bao'dan
鱼香菜心	yu'xiang'cai'xin
鱼香豇豆	yu'xiang'jiang'dou
鱼鲞	yu'xiang
鱿鱼三鲜	you'yu'san'xian
鱿鱼丝	you'yu'si
鱿鱼烩杨桃	you'yu'hui'yang'tao
鱿鱼鲞	you'yu'xiang
鲁菜	lu'cai
鲍汁百龄菇	bao'zhi'bai'ling'gu
鲍鱼丝瓜粥	bao'yu'si'gua'zhou
鲍鱼大枣	bao'yu'da'zao
鲍鱼汁	bao'yu'zhi
鲍鱼罐头	bao'yu'guan'tou
鲍鱼肚片汤	bao'yu'du'pian'tang
鲍鱼菇	bao'yu'gu
鲑鱼慕斯泡芙	gui'yu'mu'si'pao'fu
鲜人参茶罐头	xian'ren'shen'cha'guan'tou
鲜味大虾	xian'wei'da'xia
鲜哈密瓜汁	xian'ha'mi'gua'zhi
鲜哈蜜瓜汁	xian'ha'mi'gua'zhi
鲜奶凤梨派	xian'nai'feng'li'pai
鲜奶油辫子面包	xian'nai'you'bian'zi'mian'bao
鲜奶泡夫	xian'nai'pao'fu
鲜奶煮鱼	xian'nai'zhu'yu
鲜奶碗糕	xian'nai'wan'gao
鲜奶蘑菇	xian'nai'mo'gu
鲜奶蛋卷	xian'nai'dan'juan
鲜奶蛋糕	xian'nai'dan'gao
鲜奶鱼茸羹	xian'nai'yu'rong'geng
鲜奶鱼	xian'nai'yu
鲜得味香辣金枪鱼罐头	xian'de'wei'xiang'la'jin'qiang'yu'guan'tou
鲜果明珠羹	xian'guo'ming'zhu'geng
鲜果羹	xian'guo'geng
鲜果芋泥	xian'guo'yu'ni
鲜果银耳	xian'guo'yin'er
鲜柚子汁	xian'you'zi'zhi
鲜柠脆虾球	xian'ning'cui'xia'qiu
鲜椒嫩仔鸡	xian'jiao'nen'zi'ji
鲜橙多	xian'cheng'duo
鲜橙汁汽水	xian'cheng'zhi'qi'shui
鲜溜鸡丁	xian'liu'ji'ding
鲜炒鱼片	xian'chao'yu'pian
鲜炸虾饼	xian'zha'xia'bing
鲜牛奶煮鱼	xian'niu'nai'zhu'yu
鲜百合煎酿绿豆	xian'bai'he'jian'niang'lv'dou
鲜竹牛肉	xian'zhu'niu'rou
鲜肉包子	xian'rou'bao'zi
鲜肉包	xian'rou'bao
鲜肉月饼	xian'rou'yue'bing
鲜肉榨菜月饼	xian'rou'zha'cai'yue'bing
鲜花滕萝饼	xian'hua'teng'luo'bing
鲜花白玉鸡片	xian'hua'bai'yu'ji'pian
鲜花饼	xian'hua'bing
鲜荔枝	xian'li'zhi
鲜菇虾丸汤	xian'gu'xia'wan'tang
鲜菇鱼片	xian'gu'yu'pian
鲜蘑炒肉片	xian'mo'chao'rou'pian
鲜蘑菇炖豆腐	xian'mo'gu'dun'dou'fu
鲜蘑蒸鸡	xian'mo'zheng'ji
鲜蘑豆腐	xian'mo'dou'fu
鲜虾扒豆苗	xian'xia'ba'dou'miao
鲜虾腐皮卷	xian'xia'fu'pi'juan
鲜虾蟹柳沙拉	xian'xia'xie'liu'sha'la
鲜贝冬瓜球	xian'bei'dong'gua'qiu
鲜饼	xian'bing
鲜鸡汤	xian'ji'tang
鲤跃龙门	li'yue'long'men
鲤鱼汤	li'yu'tang
鲤鱼粥	li'yu'zhou
鲤鱼苦瓜汤	li'yu'ku'gua'tang
鲤鱼补血汤	li'yu'bu'xue'tang
鲥鱼	shi'yu
鲫鱼汆白玉	ji'yu'cuan'bai'yu
鲫鱼豆腐汤	ji'yu'dou'fu'tang
鲮鱼罐头	ling'yu'guan'tou
鳄梨	e'li
鳎目鱼	ta'mu'yu
鳕鱼	xue'yu
鳝鱼炒玉兰	shan'yu'chao'yu'lan
鳝鱼鸡蛋卷	shan'yu'ji'dan'juan
鸟苷酸二钠	niao'gan'suan'er'na
鸠园栗香茶	jiu'yuan'li'xiang'cha
鸠坑毛尖	jiu'keng'mao'jian
鸡丝月饼	ji'si'yue'bing
鸡丝汤面	ji'si'tang'mian
鸡丝炒耳块	ji'si'chao'er'kuai
鸡丝燕窝	ji'si'yan'wo
鸡丝米粉	ji'si'mi'fen
鸡丝虎掌菌	ji'si'hu'zhang'jun
鸡丝豆苗	ji'si'dou'miao
鸡包鱼翅	ji'bao'yu'chi
鸡尾酒泡芙	ji'wei'jiu'pao'fu
鸡尾酒	ji'wei'jiu
鸡心豆	ji'xin'dou
鸡杂	ji'za
鸡棕酥	ji'zong'su
鸡汁土豆泥	ji'zhi'tu'dou'ni
鸡汁燕窝	ji'zhi'yan'wo
鸡汁菜卷	ji'zhi'cai'juan
鸡汁虾卷	ji'zhi'xia'juan
鸡汁锅贴	ji'zhi'guo'tie
鸡汁鞭打绣球	ji'zhi'bian'da'xiu'qiu
鸡汁	ji'zhi
鸡汤氽海蚌	ji'tang'tun'hai'bang
鸡汤煮千丝	ji'tang'zhu'qian'si
鸡油年糕	ji'you'nian'gao
鸡油菜心	ji'you'cai'xin
鸡油香菇	ji'you'xiang'gu
鸡沾口蘑	ji'zhan'kou'mo
鸡火蹄燕	ji'huo'ti'yan
鸡焖蟹煲	ji'men'xie'bao
鸡粉调味料	ji'fen'tiao'wei'liao
鸡粒玉米	ji'li'yu'mi
鸡粒韭菜盒	ji'li'jiu'cai'he
鸡纵菌罐头	ji'zong'jun'guan'tou
鸡纵	ji'zong
鸡翅羊肚菌	ji'chi'yang'du'jun
鸡肉滷味	ji'rou'lu'wei
鸡肉脆脆肠	ji'rou'cui'cui'chang
鸡肠饼	ji'chang'bing
鸡腿汤	ji'tui'tang
鸡茸瓦楞卷	ji'rong'wa'leng'juan
鸡茸笔架鱼肚	ji'rong'bi'jia'yu'du
鸡茸芦笋	ji'rong'lu'sun
鸡茸花菜	ji'rong'hua'cai
鸡茸银杏	ji'rong'yin'xing
鸡茸银耳	ji'rong'yin'er
鸡蓉奶油羹	ji'rong'nai'you'geng
鸡蛋包藕	ji'dan'bao'ou
鸡蛋春饼	ji'dan'chun'bing
鸡蛋果奶	ji'dan'guo'nai
鸡蛋炒菠菜	ji'dan'chao'bo'cai
鸡蛋熨斗糕	ji'dan'yun'dou'gao
鸡蛋翡翠面	ji'dan'fei'cui'mian
鸡蛋荞麦饼	ji'dan'qiao'mai'bing
鸡血汤	ji'xue'tang
鸡豆花	ji'dou'hua
鸡里爆	ji'li'bao
鸭丝掐菜	ya'si'qia'cai
鸭掌包	ya'zhang'bao
鸭羹	ya'geng
鸭肉	ya'rou
鸭肝	ya'gan
鸭肾汤	ya'shen'tang
鸭脖	ya'bo
鸭腿	ya'tui
鸭血豆腐汤	ya'xue'dou'fu'tang
鸭黄豆腐	ya'huang'dou'fu
鸳鸯哺乳	yuan'yang'bu'ru
鸳鸯土豆泥	yuan'yang'tu'dou'ni
鸳鸯夹心饼	yuan'yang'jia'xin'bing
鸳鸯情人咖啡	yuan'yang'qing'ren'ka'fei
鸳鸯毛巾蛋糕	yuan'yang'mao'jin'dan'gao
鸳鸯酥盒	yuan'yang'su'he
鸳鸯酥	yuan'yang'su
鸳鸯饼	yuan'yang'bing
鸳鸯鱖鱼	yuan'yang'jue'yu
鸳鸯鱼枣	yuan'yang'yu'zao
鸳鸯鳜鱼	yuan'yang'gui'yu
鸳鸯鸡粥	yuan'yang'ji'zhou
鸳鸳珍珠汤	yuan'yuan'zhen'zhu'tang
鸽戏牛蛙	ge'xi'niu'wa
鹅石板江湖菜	e'shi'ban'jiang'hu'cai
鹅肉	e'rou
鹅肝坯	e'gan'pi
鹅肝酱	e'gan'jiang
鹅肝	e'gan
鹅黄肉	e'huang'rou
鹌鹑枸杞粥	an'chun'gou'qi'zhou
鹌鹑蛋罐头	an'chun'dan'guan'tou
鹌鹑蛋面包	an'chun'dan'mian'bao
鹤庆乾酒	he'qing'qian'jiu
鹦鹉莴笋	ying'wu'wo'sun
鹰扬虎视	ying'yang'hu'shi
鹰金钱鱼罐头	ying'jin'qian'yu'guan'tou
鹿宛茶	lu'wan'cha
鹿肉汤	lu'rou'tang
鹿肉罐头	lu'rou'guan'tou
鹿肉	lu'rou
鹿茸炖羊肾	lu'rong'dun'yang'shen
鹿茸牛肉卷	lu'rong'niu'rou'juan
鹿角胶	lu'jiao'jiao
鹿角菜蛤蚧水鱼汤	lu'jiao'cai'ge'jie'shui'yu'tang
鹿鞭壮阳汤	lu'bian'zhuang'yang'tang
麒福礼盒	qi'fu'li'he
麒麟桂鱼	qi'lin'gui'yu
麒麟石斑鱼	qi'lin'shi'ban'yu
麒麟石斑	qi'lin'shi'ban
麒麟鲈鱼	qi'lin'lu'yu
麝香猫咖啡	she'xiang'mao'ka'fei
麝香草酚	she'xiang'cao'fen
麦乳精	mai'ru'jing
麦仁牛肉粥	mai'ren'niu'rou'zhou
麦仔茶	mai'zai'cha
麦冬雪梨椰片炖汤	mai'dong'xue'li'ye'pian'dun'tang
麦德乐	mai'de'le
麦精酥	mai'jing'su
麦维素饼干	mai'wei'su'bing'gan
麦胚饼干	mai'pei'bing'gan
麦芬蛋糕	mai'fen'dan'gao
麦芽党参茯苓牛肚汤	mai'ya'dang'shen'fu'ling'niu'du'tang
麦芽养生茶	mai'ya'yang'sheng'cha
麦芽山楂瘦肉炖	mai'ya'shan'zha'shou'rou'dun
麦芽山楂饮	mai'ya'shan'zha'yin
麦芽粥	mai'ya'zhou
麦芽糖醇	mai'ya'tang'chun
麦芽茶	mai'ya'cha
麦芽酚	mai'ya'fen
麦角钙化醇	mai'jiao'gai'hua'chun
麦金利	mai'jin'li
麦金托什红苹果	mai'jin'tuo'shi'hong'ping'guo
麻仁当归猪踭汤	ma'ren'dang'gui'zhu'zheng'tang
麻仁牛舌酥	ma'ren'niu'she'su
麻仁酥鸭	ma'ren'su'ya
麻仁酥	ma'ren'su
麻圆	ma'yuan
麻姑茶	ma'gu'cha
麻婆豆腐	ma'po'dou'fu
麻汁豇豆	ma'zhi'jiang'dou
麻油火鸡肾	ma'you'huo'ji'shen
麻油鸡	ma'you'ji
麻烘糕	ma'hong'gao
麻球王	ma'qiu'wang
麻粉肘子	ma'fen'zhou'zi
麻糍	ma'ci
麻芝	ma'zhi
麻花腰子	ma'hua'yao'zi
麻花酥鲫鱼	ma'hua'su'ji'yu
麻薯	ma'shu
麻辣冬瓜	ma'la'dong'gua
麻辣冬笋	ma'la'dong'sun
麻辣子鸡	ma'la'zi'ji
麻辣水煮鱼	ma'la'shui'zhu'yu
麻辣烤肉	ma'la'kao'rou
麻辣烫	ma'la'tang
麻辣牛肉丝	ma'la'niu'rou'si
麻辣牛肉	ma'la'niu'rou
麻辣狗肉	ma'la'gou'rou
麻辣猪肉干	ma'la'zhu'rou'gan
麻辣猪肝	ma'la'zhu'gan
麻辣田螺	ma'la'tian'luo
麻辣白菜	ma'la'bai'cai
麻辣翡翠面	ma'la'fei'cui'mian
麻辣肉丁	ma'la'rou'ding
麻辣肉片	ma'la'rou'pian
麻辣腌制料	ma'la'yan'zhi'liao
麻辣萝卜丝	ma'la'luo'bo'si
麻辣诱惑蛙	ma'la'you'huo'wa
麻辣豆腐	ma'la'dou'fu
麻辣野鸡	ma'la'ye'ji
麻辣香水鱼	ma'la'xiang'shui'yu
麻辣鳝片	ma'la'shan'pian
麻辣鸡肫毛豆	ma'la'ji'zhun'mao'dou
麻辣黄鳝	ma'la'huang'shan
麻酥油卷儿	ma'su'you'juan'er
麻酥糖	ma'su'tang
麻酱凤尾	ma'jiang'feng'wei
麻酱拌豆腐	ma'jiang'ban'dou'fu
麻酱白菜丝	ma'jiang'bai'cai'si
麻酱笋尖	ma'jiang'sun'jian
麻酱腰片	ma'jiang'yao'pian
麻酱菠菜	ma'jiang'bo'cai
麻雀肉饼	ma'que'rou'bing
麻食子	ma'shi'zi
麻食	ma'shi
麻饼	ma'bing
麻香酥鸭	ma'xiang'su'ya
黄原胶	huang'yuan'jiao
黄山三美	huang'shan'san'mei
黄山云翠	huang'shan'yun'cui
黄山毛峰茶	huang'shan'mao'feng'cha
黄山毛峰	huang'shan'mao'feng
黄山炖鸽	huang'shan'dun'ge
黄山贡尖茶	huang'shan'gong'jian'cha
黄岩桔饼	huang'yan'ju'bing
黄心管儿	huang'xin'guan'er
黄松糕	huang'song'gao
黄格蟹	huang'ge'xie
黄桂稠酒	huang'gui'chou'jiu
黄桃丁罐头	huang'tao'ding'guan'tou
黄桃摩司	huang'tao'mo'si
黄桃罐头	huang'tao'guan'tou
黄桥烧饼	huang'qiao'shao'bing
黄油圆蛋糕	huang'you'yuan'dan'gao
黄油曲奇	huang'you'qu'qi
黄油汁	huang'you'zhi
黄油	huang'you
黄泥煨鸡	huang'ni'wei'ji
黄泥螺	huang'ni'luo
黄焖全鸡	huang'men'quan'ji
黄焖甲鱼	huang'men'jia'yu
黄焖肉	huang'men'rou
黄焖鳗	huang'men'man
黄焖鸡块	huang'men'ji'kuai
黄焖鸭肝	huang'men'ya'gan
黄狮茶	huang'shi'cha
黄瓜拌鸭掌	huang'gua'ban'ya'zhang
黄瓜汆里脊片	huang'gua'cuan'li'ji'pian
黄瓜炒肉丝	huang'gua'chao'rou'si
黄瓜苹果汁	huang'gua'ping'guo'zhi
黄瓜葡萄香蕉汁	huang'gua'pu'tao'xiang'jiao'zhi
黄瓜蟹肉筒	huang'gua'xie'rou'tong
黄瓜鸡杂汤	huang'gua'ji'za'tang
黄石港饼	huang'shi'gang'bing
黄石溪毛峰	huang'shi'xi'mao'feng
黄米面凉糕	huang'mi'mian'liang'gao
黄米面烤粩	huang'mi'mian'kao'lao
黄精炖肉	huang'jing'dun'rou
黄精蒸鸡	huang'jing'zheng'ji
黄精鸡蛋汤	huang'jing'ji'dan'tang
黄糕	huang'gao
黄耆茯苓鸡汤	huang'qi'fu'ling'ji'tang
黄花菜瘦肉汤	huang'hua'cai'shou'rou'tang
黄花鱼	huang'hua'yu
黄茶	huang'cha
黄蜀葵胶	huang'shu'kui'jiao
黄袍加身	huang'pao'jia'shen
黄豆炖猪脚	huang'dou'dun'zhu'jiao
黄豆猪肝汤	huang'dou'zhu'gan'tang
黄豆	huang'dou
黄金咖喱角	huang'jin'ga'li'jiao
黄金堡	huang'jin'bao
黄金杏仁莲蓉月饼	huang'jin'xing'ren'lian'rong'yue'bing
黄金肉丸	huang'jin'rou'wan
黄金虾托	huang'jin'xia'tuo
黄金豆腐	huang'jin'dou'fu
黄金马蹄条	huang'jin'ma'ti'tiao
黄鱼丝	huang'yu'si
黄鱼鱼肚汤	huang'yu'yu'du'tang
黑京果	hei'jing'guo
黑加仑红	hei'jia'lun'hong
黑啤酒	hei'pi'jiu
黑木耳红枣饮	hei'mu'er'hong'zao'yin
黑杂粮吐司面包	hei'za'liang'tu'si'mian'bao
黑松沙士	hei'song'sha'shi
黑松	hei'song
黑森林蛋糕	hei'sen'lin'dan'gao
黑森林	hei'sen'lin
黑椒牛仔骨	hei'jiao'niu'zai'gu
黑椒牛柳	hei'jiao'niu'liu
黑椒	hei'jiao
黑樱桃	hei'ying'tao
黑玉米饮料	hei'yu'mi'yin'liao
黑玫瑰咖啡	hei'mei'gui'ka'fei
黑白冰咖啡	hei'bai'bing'ka'fei
黑米松糕	hei'mi'song'gao
黑米膳粥	hei'mi'shan'zhou
黑米面炸糕	hei'mi'mian'zha'gao
黑米	hei'mi
黑糖珊瑚草	hei'tang'shan'hu'cao
黑胡椒整粒	hei'hu'jiao'zheng'li
黑胡椒牛柳	hei'hu'jiao'niu'liu
黑胡椒碎	hei'hu'jiao'sui
黑胡椒风味腌制料	hei'hu'jiao'feng'wei'yan'zhi'liao
黑胡椒	hei'hu'jiao
黑茶	hei'cha
黑莓果子爽罐头	hei'mei'guo'zi'shuang'guan'tou
黑豆渣蜂蜜小面包	hei'dou'zha'feng'mi'xiao'mian'bao
黑豆渣黑芝麻餐包	hei'dou'zha'hei'zhi'ma'can'bao
黑豆焖猪蹄	hei'dou'men'zhu'ti
黑豆红	hei'dou'hong
黑豆鲤鱼汤	hei'dou'li'yu'tang
黑豆	hei'dou
黑香槟	hei'xiang'bin
黑龙江省	hei'long'jiang'sheng
黔味大虾	qian'wei'da'xia
鼎丰南乳汁	ding'feng'nan'ru'zhi
鼎丰料酒王	ding'feng'liao'jiu'wang
鼎丰玫瑰乳腐	ding'feng'mei'gui'ru'fu
鼎丰白醋	ding'feng'bai'cu
鼎丰红醋	ding'feng'hong'cu
鼎丰醋精	ding'feng'cu'jing
鼎丰香糟卤	ding'feng'xiang'zao'lu
鼎湖上素	ding'hu'shang'su
鼓椒鸡丁	gu'jiao'ji'ding
鼓汁排骨	gu'zhi'pai'gu
鼠尾草粉	shu'wei'cao'fen
鼠尾草	shu'wei'cao
齐山毛尖	qi'shan'mao'jian
龍韻徽酒	long'yun'hui'jiu
龙丹	long'dan
龙井竹荪	long'jing'zhu'sun
龙井茶	long'jing'cha
龙井虾仁	long'jing'xia'ren
龙井金鱼	long'jing'jin'yu
龙俐鱼	long'li'yu
龙凤双腿	long'feng'shuang'tui
龙凤呈祥	long'feng'cheng'xiang
龙凤柔情	long'feng'rou'qing
龙凤腿	long'feng'tui
龙凤配	long'feng'pei
龙凤饼	long'feng'bing
龙凤鲜汤	long'feng'xian'tang
龙口	long'kou
龙宫矿泉饮料	long'gong'kuang'quan'yin'liao
龙川矿泉水	long'chuan'kuang'quan'shui
龙抄手	long'chao'shou
龙毫花茶	long'hao'hua'cha
龙潭钓玉牌	long'tan'diao'yu'pai
龙爪肉丝	long'zhua'rou'si
龙爪鱼翅	long'zhua'yu'chi
龙王夜宴	long'wang'ye'yan
龙眼凤肝	long'yan'feng'gan
龙眼咸烧白	long'yan'xian'shao'bai
龙眼甜烧白	long'yan'tian'shao'bai
龙眼肉	long'yan'rou
龙眼莲子羹	long'yan'lian'zi'geng
龙眼虾仁	long'yan'xia'ren
龙眼酥	long'yan'su
龙眼首乌羹	long'yan'shou'wu'geng
龙翅	long'chi
龙胆酒	long'dan'jiu
龙脊茶	long'ji'cha
龙脑	long'nao
龙虎斗	long'hu'dou
龙虾汤	long'xia'tang
龙虾酥糖	long'xia'su'tang
龙身凤尾虾	long'shen'feng'wei'xia
龙须燕丸	long'xu'yan'wan
龙须糕	long'xu'gao
龙须糖	long'xu'tang
龙须菜	long'xu'cai
龙须酥	long'xu'su
龙须长春燕	long'xu'chang'chun'yan
龟山茶	gui'shan'cha